abactus	m
abacus	m
abaris_n	m
abascantus_n	m
abas_n	m
abauus	m
abdagaeses_n	???
abdalonymus_n	m
abdera_n	n
abditum	???
abdomen	n
abducillus_n	???
abdus_n	m
abella_n	f
abgarus_n	m
abiectio	
abies	m
abii_n	*
abisares_n	m
abisares_n	m
abistamenes_n	m
abitus	m
abnepos	???
abnoba_n	m
abolitio	f
abolla	f
aborigines_n	m
abortio_1	
abortus	m
abrotonum	n
abrotonus	m
abruptum	???
abscessus	m
absentia	f
absinthium	n
absolutio	f
abstinentia	f
absumedo	f
abudius_n	*
abulites_n	m
abundans_1	*
abundantia	f
abydus_n	*
acacia	f
academia_n	f
academica_n	???
academici_n	m
academus_n	m
acadira_n	???
acanthis_n	f
acanthus	m
acarnanes_n	???
acarnania_n	f
acastus_n	m
acca_n	f
accensus_1	m
acceptio	f
acceptum	n
accessio	f
accessus	m
accidens	n
accipiter	m
accipitrina	f
accitus	m
accius_n	m
acclamatio	f
accliuitas	f
accola	f
accommodatio	f
acco_n	m
accubitio	f
accumulator	m
accursus	m
accusatio	f
accusator	m
accusatrix	f
acerbitas	f
acerbum	n
acerra	m
acerrae_n	f
acerronia_n	f
acerronius_n	*
aceruus	???
acer_1	m
acesines_n	m
acesta_n	n
acestenses_n	2
acestes_n	m
acetabulum	n
acetum	n
achaei_n	*
achaemenes_n	m
achaemenides_n	m
achaeus_n	*
achaia_n	f
achaici_n	masculin
achates_n	m
achates_n	m
achelous_n	m
acheron_n	m
acheruntia_n	f
achillas_n	m
achilles_n	m
achilles_n	m
achiui_n	*
achradina_n	f
acia	f
acidalia_n	f
acidinus_n	m
acies	f
acilianus_n	*
acilia_n	2
acilius_n	*
acina	f
acinaces	m
acinum	n
acinus	m
acipenser	???
aclys	f
acmonenses_n	3
acmonides_n	m
acoenonoetus	m
aconitum	n
aconteus_n	m
acontius_n	m
acor	m
acratus_n	m
acrimonia	f
acrisius_n	*
acroama	n
acroceraunia_n	f
acropolistis_n	f
acta	f
actio	f
actium_n	n
actiuncula	f
actor	m
actor_n	m
actuaria	f
actuarius_1	*
actum	n
actumerus_n	4
actus_1	m
aculeus	m
acumen	n
acus_2	m
acus_3	m
acutia_n	f
acutius_n	*
acutum	n
acylla_n	f
acyllitani_n	3
adactus	m
adamas	m
adamastus_n	m
adauctus	*
adaugmen	n
addictio	f
additamentum	n
adelphi_n	m
ademptio	
adeps	2
adgandestrius_n	m
adhaesus	m
adherbal_n	m
adhortatio	f
adiabeni_n	*
adiatuanus_n	4
adiectio	
adiectus	m
adimantus_n	m
adipatum	n
adipes	???
aditus	m
adiumentum	n
adiutorium	n
adiutor_1	m
adiutrix	f
adiutrix_n	f
admetus_n	m
adminiculum	n
administer	m
administra	f
administratio	f
admirabilitas	f
admiratio	f
admirator	m
admissarius	*
admissio	f
admissum	n
admixtio	f
admonitio	f
admonitus	m
admurmuratio	f
adolescens_1	???
adolescentia	???
adolescentula	f
adolescentulus	m
adoneus_n	*
adonis_n	???
adoptatio	f
adoptio	f
ador	2
adorea	f
adramytteum_n	n
adrana_n	f
adrastus_n	m
aduatici_n	*
aduatuca_n	f
aduectus	m
aduena	2
aduenticia	f
aduenticium	neutre
aduentor	m
aduentus	m
aduersaria	n
aduersarius_1	*
aduersum	n
adulatio	f
adulator	m
adulescentia	f
adultera	f
adulterium	n
adulter_1	*
aduocatio	f
aduocatus	m
adytum	n
aeacides_n	m
aeacides_n	m
aeacus_n	m
aebutius_n	*
aecus_n	masculin
aedes	m
aedicula	f
aedificatio	f
aedificator	m
aedificium	n
aedilicius_1	*
aedilis	m
aedilitas	f
aedituens	m
aeditumus	m
aedituus	m
aedui_n	*
aeetes_n	f
aefula_n	f
aegaeum_n	n
aegaleus_n	???
aegeae_n	f
aeger_1	*
aegeus_n	*
aegialus_n	m
aegides_n	m
aegimurus_n	m
aegina_n	f
aeginetae_n	m
aeginium_n	n
aegis	f
aegisthus_n	m
aegium_n	n
aegoceros_n	m
aegon_n	m
aegrimonia	f
aegritomarus_n	m
aegritudo	f
aegror	m
aegrotatio	f
aegrum	n
aegyptii_n	m
aegyptus_n	2
aelianus_n	*
aelia_n	f
aelius_n	*
aelurus	m
aemilianus_n	*
aemilia_n	???
aemilius_n	*
aemula	f
aemulatio	f
aemulator	m
aemulatus	m
aemulus_1	*
aeneadae_n	???
aeneas_n	m
aeneator	m
aeneum	n
aenigma	f
aenobarbus_n	m
aenum	n
aenus_n	2
aeolia_n	f
aeolis_n	f
aeolus_n	m
aequabilitas	f
aequalis_1	m
aequalitas	f
aequanimitas	f
aequatio	f
aequimaelium_n	n
aequinoctium	n
aequitas	f
aequi_n	*
aequor	n
aequor_n	n
aequum	n
aequus_n	*
aer	m
aeraria	f
aerarium	n
aerarius_1	*
aeria_n	f
aerugo	f
aerumna	f
aes	
aeschines_n	m
aeschrion_n	m
aeschylus_n	m
aesculapius_n	*
aesculetum	n
aesculus	m
aeserninus_n	*
aesopus_n	m
aestas	f
aestii_n	*
aestimatio	f
aestimator	m
aestiua	n
aestuarium	n
aestus	m
aetas	f
aetatula	f
aeternitas	f
aeternum_1	neutre
aether	m
aethiopes_n	3
aethiopia_n	f
aethra	f
aethra_n	f
aetidemus_n	4
aetna_n	f
aetnenses_n	2
aetolia_n	f
aetolis_n	f
aetoli_n	*
aeuum	n
aeuus	*
afer_n	*
affabilitas	f
affatus	m
affectatio	f
affectator	m
affectio	f
affectus_1	m
affinis_1	*
affinitas	f
affirmatio	f
afflatus	m
afflictatio	f
afflictor	m
affluentia	f
afinius_n	4
afraniani_n	???
afranius_n	*
africana_n	f
africani_n	*
africanus_n	*
africa_n	f
africus_n	*
afri_n	3
agaga	f
agamemnonides_n	m
agamemnon_n	???
agaso	m
agathinus_n	4
agathocles_n	m
agatho_n	m
agathyrsi_n	*
agedincum_n	n
agellus	*
agenor_n	m
agens_1	m
ager	m
agermus_n	4
ager_n	m
agesilaus_n	m
aggar_n	2
agger	m
aggestus	m
agilitas	f
agis_n	m
agitatio	f
agitator	m
agmen	n
agna	f
agnalia_n	n
agnatus	m
agnellus	*
agnina	f
agnus	m
agon	m
agonia	n
agonia_n	n
agonis_n	f
agoranomus	m
agrarii	m
agrestis_1	*
agrestis_n	*
agrianes_n	m
agriani_n	3
agricola	m
agricola_n	m
agricultor	???
agricultura	f
agrigentini_n	*
agrigentum_n	n
agrippa_n	m
agrippina_n	f
agrippinenses_n	m
agrippinus_n	*
agrius_n	*
agyllini_n	???
agyrinenses_n	2
agyrium_n	n
ahala_n	m
ahenobarbus_n	m
aiax_n	m
ala	f
alabanda_n	n
alabaster	???
alacritas	f
alani_n	*
alapa	f
alarii	m
alaudae_n	f
albana_n	f
albani_n	*
albanum_n	n
alba_n	f
albesius_n	4
albici_n	*
albina_n	2
albingaunum_n	n
albinouanus_n	m
albintimilium_n	n
albinus_n	*
albis_n	m
albius_n	*
albruna_n	f
albucilla_n	2
albucius_n	*
albula_n	f
album	n
albunea_n	f
alburnus_n	m
alcaeus_n	*
alcander_n	m
alcanor_n	m
alcathous_n	m
alcedonia	n
alces	m
alcesimus_n	m
alcestis_n	*
alcibiades_n	m
alcides_n	m
alcides_n	m
alcimedon_n	m
alcinous_n	m
alcis_n	???
alcmaeus_n	???
alcmena_n	f
alcmene_n	f
alcon_n	m
alcyon	f
alcyoneum	n
alea	m
aleator	m
alebria	n
alec	n
aleo	m
alesia_n	f
ales_1	f
ales_n	f
aletrinates_n	???
aleuas_n	m
alexander_n	m
alexandrea_n	f
alexandria_n	f
alexandrini_n	???
alexa_n	m
alexis_n	m
alfenus_n	*
alfius_n	*
alga	f
algidus_n	*
algor	m
algus	m
aliacmon_n	m
alica	f
alicula	f
alienatio	f
alienigena	m
alienum	n
alienus_1	*
alienus_n	*
alimentum	n
alimonium	n
alipilus	m
alison_n	???
allapsus	m
allec	
alledius_n	*
allegatio	f
alleuamentum	n
allex	n
alliaria_n	2
allia_n	f
allienus_n	*
allium	???
allius_n	*
allobroges_n	m
allobrogici_n	masculin
allobrogicus_n	*
allocutio	f
alloquium	n
almo_n	m
alnus	f
alogia	f
aloidae_n	f
alpes_n	f
alphesiboea_n	f
alphesiboeus_n	m
alpheus_n	*
alpinius_n	*
alpini_n	*
alpinus_n	*
alpis_n	???
alsiense_n	neutre
alsus_n	m
altar	
altare	n
altercatio	f
althaea_n	f
altilis_1	*
altinates_n	m
altinum_n	n
altinus_n	*
altitudo	f
altor	m
altrix	f
altum	n
aluarium	n
alucinatio	f
alueolus	m
alueus	m
alumna	f
alumnus_1	m
aluntini_n	masculin
aluntium_n	n
aluta_1	f
aluta_2	f
aluus	???
alyattes_n	m
amalthea_n	f
amandatio	f
amans_1	m
amantia_n	f
amantini_n	*
amanus_n	m
amara	f
amaracinum	n
amaracus	m
amarantus	m
amarities	f
amaritudo	f
amaror	m
amaryllis_n	f
amasenus_n	???
amasis_n	m
amasiuncula	f
amasiunculus	m
amasius	m
amastriani_n	???
amastrus_n	m
amata_n	f
amathusia_n	f
amatio	f
amator	m
amatorium	n
amatrix	f
amazonis_n	f
amazon_n	f
ambactus	m
ambages	f
ambarri_n	*
ambestrix	f
ambiani_n	*
ambibarii_n	*
ambiguitas	f
ambiguum	n
ambiliati_n	*
ambiorix_n	m
ambitio	
ambitio_n	
ambitus	m
ambiuareti_n	*
ambiuius_n	*
ambracia_n	f
ambraciotes_n	f
ambrosia	f
ambrosius_n	*
ambubaia	f
ambulatio	f
ambulator	m
ambulatrix	f
ameana_n	2
amedines_n	m
amellus	???
amentia	f
amentum	n
ameria_n	f
amerini_n	???
ames	m
amestratini_n	???
amestratus_n	f
amethystina	n
amethystus	*
amica	f
amicitia	f
amicities	f
amictus	m
amicula	f
amiculum	n
amiculus	m
amicus_1	m
amiseni_n	*
amisia_n	f
amissio	f
amissus_n	m
amisus_n	m
amita	f
ammius_n	*
ammon_n	m
amnis	m
amoena	f
amoenitas	f
amomum	n
amor	m
amorgus_n	2
amor_n	m
amphaeus_n	m
amphiaraus_n	m
amphictyones_n	m
amphilochia_n	f
amphilochi_n	*
amphilochus_n	m
amphion_n	???
amphipolis_n	f
amphiteatrum	n
amphitheater	m
amphitheatrum	n
amphitryoniades_n	m
amphitryon_n	m
amphora	f
amphoterus_n	m
amphrysus_n	m
ampius_n	*
ampla	f
amplexus	m
amplificatio	f
amplitudo	f
amplius	neutre
ampsanctus_n	m
ampsiuarii_n	*
ampulla	f
amputatio	f
amulius_n	*
amullius_n	4
amurca	f
amyclae_n	f
amycus_n	m
amydon_n	f
amygdalum	n
amylum	???
amyntas_n	m
amyntor_n	m
amystis	f
anabathrum	n
anacharsis_n	m
anadema	n
anagnia_n	f
anagnini_n	*
anagnostes	m
analecta	m
analogia	f
anapaestus	*
anapus_n	m
anartes_n	2
anas_1	m
anathymiasis	f
anaticula	f
anatina	f
anaxagoras_n	m
anaxarchus_n	m
ana_n	m
ancaeus_n	m
ancalites_n	m
anceps_1	*
ancharius_n	*
anchemolus_n	m
anchises_n	m
ancile	n
ancile	n
ancilla	f
ancillariolus	m
ancillula	f
ancona_n	f
ancora	f
ancus_n	m
ancyra_n	f
andania_n	f
andecaui_n	*
andecumborius_n	m
andes_n	m
andria_n	m
androgeus_n	m
andromacha_n	f
andromachus_n	m
andromeda_n	f
andromenes_n	m
andronicus_n	*
andron_n	m
androsthenes_n	m
andrus_n	2
anellus	m
anethum	???
anfractus_1	m
angellus	m
angina	f
angiportum	n
angiportus	m
angitia_n	f
anglii_n	*
angor	m
angriuarii_n	*
anguilla	f
anguis	*
anguis_n	*
angulus	m
angustia	f
angustum	n
anhelitus	m
anicetus_n	*
anicius_n	*
anicula	f
anien_n	m
anilitas	f
anima	f
animaduersio	f
animaduersor	m
animal	n
animans_1	???
animulus	m
animus	m
anio_n	m
anisum	n
anius_n	*
annaea_n	???
annaeus_n	*
annalis_1	2
annalis_n	2
anna_n	f
annexus	m
annia_n	???
annicerii_n	m
annius_n	*
annona	f
annotatio	f
annotator	m
annus	m
annus_n	m
annuum	n
anquillaria_n	f
ansa	f
anser	m
anser_n	m
antaeus_n	m
antandrus_n	f
antecessio	f
antecessor	m
antecursor	m
antegua_n	2
anteia_n	2
anteius_n	???
antemnae_n	f
antemna_n	f
antenna	???
antenoridae_n	m
antenor_n	m
antepagmentum	n
antes	m
antescholanus	m
antesignanus_1	m
anthrax_n	m
anthropinus_n	m
anticato_n	m
anticyra_n	f
antigenes_n	m
antigone_n	f
antigonus_n	m
antilochus_n	m
antimachus_n	m
antinous_n	m
antiochenses_n	???
antiochia_n	f
antiochus_n	m
antiopa_n	f
antiope_n	f
antipater_n	m
antiphanes_n	m
antipodes	m
antipolis_n	f
antiquaria	f
antiquarius_1	m
antiqui	m
antiquitas	f
antiquum	n
antistes	2
antisthenes_n	m
antistia_n	???
antistita	f
antistius_n	*
antitheton	n
antium_n	n
antius_n	*
antoniaster_n	m
antonia_n	???
antoninus_n	*
antonius_n	*
antrum	n
anubis_n	m
anulus	m
anus_1	f
anus_2	f
anxietas	f
anxur_n	*
anytus_n	m
aonides_n	2
aorsi_n	*
apamea_n	f
apameni_n	*
apamenses_n	3
apella_n	m
apelles_n	m
apenninicola_n	2
apenninus_n	*
aper	m
apertum	n
aper_n	m
apex	m
apheliotes_n	m
aphidnae_n	???
aphidna_n	f
aphidnus_n	4
aphobetus_n	m
aphrodisienses_n	???
apicata_n	2
apicius_n	*
apicula	f
apidanus_n	m
apidius_n	4
apinius_n	4
apion_n	???
apis	m
apis_n	m
apium	n
aplustre	n
aplustre	n
apodyterium	???
apoecides_n	m
apollinaris_n	2
apollodorus_n	m
apolloniatae_n	m
apolloniates_n	2
apollonia_n	f
apollonidenses_n	2
apollonides_n	m
apollonis_n	f
apollonius_n	*
apollo_n	m
aponiana_n	f
aponianus_n	m
aponius_n	*
apophoreta_1	n
apophoreta_2	n
apotheca	m
apparatus_1	m
apparitio	f
apparitor	m
appellatio	f
appellator	m
appendicula	f
appendix	f
appenninus_n	???
appetitio	f
appetitus	m
appianus_n	*
appias_n	f
appia_n	f
appius_n	*
applicatio	f
approbatio	f
appropinquatio	f
appuleia_n	???
appuleius_n	*
appulsus	m
appus_n	4
apricatio	f
apricum	n
aprilis_n	2
apronianus_n	*
apronia_n	f
apronius_n	*
apsus_n	m
apula_n	2
apuleius_n	*
apulia_n	f
apyrenum	n
aqua	f
aqualiculus	m
aqualis_1	
aquarium	n
aquarius_1	m
aquarius_n	m
aquatio	f
aquator	m
aquiculus_n	4
aquila	2
aquila_n	2
aquileia_n	f
aquilex	m
aquilia_n	???
aquilifer	m
aquilius_n	*
aquilo	m
aquilo_n	m
aquinates_n	3
aquinius_n	*
aquinum_n	n
aquinus_n	*
aquitania_n	f
aquitani_n	*
aquitanus_n	*
aquula	f
ara	f
arabes_n	m
arabia_n	f
arabs_n	*
arabus_n	*
arachosii_n	*
aracinthus_n	m
aradus_n	m
aranea	f
araneus_1	*
araricus_n	*
araris_n	m
arar_n	m
aratio	f
arator	m
aratrum	n
aratus_n	m
arauisci_n	*
araxes_n	m
ara_n	f
arbela_n	n
arbiter	m
arbitra	f
arbitratus	m
arbitrium	n
arbor	f
arbuscula	f
arbuscula_n	f
arbustum	n
arbutum	n
arbutus	f
arca	f
arcades_n	m
arcadia_n	f
arcanum	n
arcas_n	m
arcens_n	???
arcesilaus_n	m
arcessitor	m
arcetius_n	4
archagathus_n	m
archelaus_n	m
archemorus_n	m
archestrata_n	2
archetypus	*
archias_n	m
archibulus_n	4
archidamus_n	m
archidemus_n	m
archigenes_n	m
archilochus_n	m
archimagirus	m
archimedes_n	m
archipirata	m
archippus_n	m
architectura	f
architectus	m
archytas_n	m
arcisellium	n
arctophylax_n	m
arcturus_n	m
arctus_n	f
arcula	f
arcularius	m
arcus	m
arcus_n	m
arda_n	m
ardea	f
ardeatinum_n	neutre
ardea_n	f
ardor	m
arduenna_n	f
arduum	n
area	f
arecomici_n	*
arelas_n	f
arelate_n	n
arellius_n	m
arena	f
arenacum_n	n
arenaria	f
areola	f
areopagites_n	m
areopagus_n	m
aretalogus	m
arethusa_n	f
areus_n	*
arganthonius_n	m
arganthus_n	m
argei_n	*
argentaria	f
argentarius_1	*
argenteus_1	m
argentifodina	???
argentum	n
argiletum_n	n
argilla	f
arginusae_n	f
argitis_n	f
argiui_n	???
argius_n	*
argi_n	m
argolici_n	masculin
argolicus_n	*
argonautae_n	2
arguetius_n	m
argumentatio	f
argumentum	n
argus_n	m
argutatio	f
argutia	f
argynnus_n	m
argyraspides_n	m
argyripa_n	f
argyrippus_n	???
ariadna_n	f
ariarathes_n	m
aricia_n	f
aricini_n	???
aridum	n
aries	m
aries_n	m
arietillus	*
arii_n	*
arimaspi_n	*
arimazes_n	3
arimazes_n	3
ariminenses_n	2
ariminum_n	n
ariobarzanes_n	m
ariouistus_n	m
arisba_n	f
arista	f
aristaeus_n	m
aristander_n	m
aristarchus_n	m
aristeus_n	???
aristides_n	m
aristides_n	m
aristippus_n	m
aristius_n	masculin
aristobulus_n	m
aristodamus_n	4
aristogiton_n	???
aristonicus_n	*
aristonus_n	m
ariston_n	???
aristophanes_n	m
aristoteles_n	m
aristo_n	m
aristus_n	*
aris_n	f
arma	n
armamaxa	f
armamenta	n
armamentarium	n
armamentum	n
armarium	n
armati	m
armatura	f
armatus_1	m
armenia_n	f
armenii_n	???
armenius_n	*
armentarius_1	*
armentum	n
armiger_1	m
armilla	f
armillatus_n	m
arminius_n	*
armipotens_n	m
armus	m
arnus_n	m
arpinas_n	f
arpinates_n	3
arpinius_n	neutre
arpinum_n	n
arpi_n	m
arpus_n	???
arquitius_n	4
arrecinus_n	4
arretini_n	*
arretium_n	n
arrhidaeus_n	m
arrianus_n	*
arria_n	f
arrionilla_n	???
arrisor	m
arrius_n	*
arrogantia	f
arrosor	m
arruns_n	m
arruntius_n	???
ars	f
arsaces_n	m
arsacidae_n	m
arsacides_n	m
arsames_n	3
arsamosata_n	???
arsanias_n	m
arsineum	n
ars_n	f
artabanus_n	m
artabazus_n	m
artacana_n	f
artaxata_n	n
artaxata_n	n
artaxias_n	m
artemidorus_n	*
artemisius_n	*
artemita_n	f
artemona_n	2
artemon_n	m
arteria	f
articulus	m
artifex	m
artificium	n
artopta	f
artoria_n	2
artorius_n	*
artum	n
artus_1	m
aruae_n	f
aruerni_n	m
aruina	f
aruiragus_n	???
arula	f
arulenus_n	*
arundinetum	n
arundo	f
aruseius_n	4
aruum	n
arx	f
arx_n	f
as	
ascanius_n	*
ascensus	m
ascia	f
asciburgium_n	n
ascla_n	f
asclepiades_n	m
asclepiodorus_n	*
asclepiodotus_n	???
asconius_n	*
ascra_n	f
ascriptio	f
ascriptor	m
asculani_n	???
asculum_n	n
ascurum_n	???
ascyltus_n	4
asella	f
asellius_n	*
asellus	m
asellus_n	m
asiaticus_n	*
asia_n	f
asicius_n	4
asilus	m
asinaria_n	f
asinarius_1	*
asina_n	m
asinius_n	*
asinus	m
asis_n	f
asius_n	*
asopis_n	f
asopus_n	m
asparagium_n	n
asparagus	m
aspar_n	m
aspauia_n	???
aspectus	m
aspendus_n	f
aspera	2
aspergo_1	f
asperitas	f
aspernatio	f
asperum	neutre
asper_n	m
aspis	m
asportatio	f
asprenas_n	???
asprenates_n	???
assacanus_n	???
assaracus_n	m
assecla	???
assectatio	f
assectator	m
assensio	f
assensor	m
assensus	m
assentatio	f
assentator	m
asser	m
asserculum	???
assertio	f
assertor	m
assessor	m
assessus	m
asseueratio	f
assiduitas	f
assignatio	f
assimulatio	f
assorini_n	*
assorum_n	n
assuetudo	f
assula	f
assultus	m
assum_2	n
assyria_n	f
assyrii_n	*
astacides_n	m
astipulator	m
astraea_n	f
astraeus_n	*
astrologia	f
astrologus	*
astronomia	f
astrum	n
asturicus_n	*
astus	m
astutia	f
astyanax_n	m
astypalaea_n	f
asudius_n	4
asuuius_n	???
asylum	n
asylus_n	m
atabulus_n	m
atalanta_n	f
ataui	m
atauus	m
atax_n	m
ategua_n	f
ateius_n	???
atellana_n	???
atella_n	f
ateste_n	n
athamanes_n	m
athamania_n	f
athamas_n	m
athenae_n	f
athena_n	f
athenienses_n	???
athenodorus_n	*
athesis_n	m
athleta	m
athos_n	m
atia_n	f
atidius_n	4
atii_n	masculin
atilius_n	*
atimetus_n	m
atinates_n	m
atina_n	f
atinius_n	*
atius_n	*
atlantides_n	f
atlantis_n	f
atlas_n	m
atomus	m
atracis_n	f
atramentum	n
atratinus_n	*
atrebates_n	m
atreus_n	*
atria_n	f
atrides_n	m
atriensis_1	m
atrium	n
atrium_n	n
atrius_n	*
atrocitas	f
attactus	m
attagen	m
attalenses_n	???
attalus_n	m
atta_n	m
attegia	f
atthis_n	f
attianus_n	masculin
attia_n	2
attica_n	f
atticinus_n	4
attici_n	3
atticus_n	*
attis_n	2
attius_n	*
attritus_1	m
attus_n	*
atys_n	f
auara	2
auaricum_n	n
auaritia	f
auaritia_n	f
auarities	f
auarus_1	*
auceps	m
auctio	f
auctor	m
auctoramentum	n
auctorati	masculin
auctoritas	f
auctus_1	*
aucupium	n
audacia	f
audentia	f
audientia	f
auditio	f
auditor	m
auditorium	n
auditum	n
auditus	m
auellana	???
auena	f
auenticum_n	n
auentinus_n	*
auerna_n	???
auerni_n	???
auernus_n	*
auersatio	f
auersio	f
auersor_1	
auersum	???
aufidienus_n	???
aufidius_n	*
aufidus_n	*
aufilena_n	f
aufilenus_n	*
augaeus_n	m
augeas_n	m
augeas_n	m
augmen	n
augur	m
augurale	n
auguratus	m
augurinus_n	???
augurium	n
augustales_n	3
augusta_n	f
augustiani_n	???
augustodunum_n	n
augustus_n	*
auia	f
auiarium	n
auidienus_n	m
auiditas	f
auidius_n	*
auienus_n	*
auillius_n	4
auiola_n	2
auiones_n	m
auis	f
auitus_n	*
auium	n
aulaeum	n
aula_1	f
aula_2	f
aulerci_n	*
aulis_n	f
auloedus	m
aulus_n	*
aunus_n	m
auocamentum	n
auocatio	f
aura	f
auraria	f
aura_n	f
aurelia_n	f
aurelius_n	*
aureus_1	m
auria_n	2
aurichalcum	???
auricilla	f
auricula	f
aurifex	m
auriga	m
auris	f
aurius_n	*
aurora	f
aurora_n	f
aurum	n
aurunca_n	f
aurunci_n	???
aurunculeia_n	2
aurunculeius_n	???
ausci_n	*
auscultatio	f
ausetani_n	*
ausonia_n	f
ausonidae_n	???
ausonii_n	*
auspex	m
auspex_n	m
auspicium	n
auster	m
austeritas	f
auster_n	m
ausum	n
ausus	m
authepsa	f
autobulus_n	m
autolycus_n	m
automatum	n
automedon_n	m
autopyros	???
autronius_n	*
autumnitas	f
autumnus_1	*
autumnus_n	*
auunculus	m
auus	m
auxiliares	m
auxiliarii	m
auxiliator	m
auxiliatus	m
auxilium	n
auximates_n	???
auximum_n	n
auzea_n	f
axia_n	f
axicia	f
axis	m
axona_n	f
babaecalus	m
baba_n	m
babylonia_n	f
babylonicum	n
babylonicum_n	n
babylonii_n	*
babylon_n	f
bacalusiae	f
bacca	f
baccar	n
bacchanal	n
bacchanalia	n
bacchanalia_n	n
bacchatio	f
baccha_n	f
bacchis_n	f
bacchius_n	*
bacchus_n	m
bacciballum	n
bacenis_n	???
bacillum	n
bactra_n	n
bactriana_n	f
bactriani_n	*
bactrus_n	m
baculum	???
baculus_n	m
baduhenna_n	2
baebius_n	*
baetasii_n	*
baetica_n	f
baetici_n	*
baetis_n	???
baeturia_n	f
bagistanes_n	???
bagoas_n	m
bagophanes_n	m
bagrada_n	m
baiae_n	f
baius_n	*
balacrus_n	m
balaena	f
balantes	???
balanus	m
balatro	m
balatro_n	m
balatus	m
balbillus_n	*
balbinus_n	m
balbus_n	m
balbutius_n	4
baleares_n	2
balearicus_n	*
balineae	2
balineum	n
balineus	4
baliscus	*
ballio_n	m
ballista	2
balnearia	n
balneator	m
balneolum	n
balsamum	n
balteum	???
balteus	m
baluentius_n	m
bambalio_n	m
bandusia_n	???
baptae_n	m
baptisterium	n
barathrum	n
barba	m
barbaria	f
barbarismus	m
barbarum	n
barbarus_1	*
barbatius_n	*
barbatoria	f
barba_n	m
barbius_n	4
barbula	f
barcaei_n	???
barcala	f
barditus	m
bardylis_n	???
barea_n	m
bargates_n	???
barium_n	n
baro	m
barrus	m
barrus_n	m
barsine_n	f
barzaentes_n	3
bascauda	f
basiatio	f
basilica	f
basilicum	n
basilicus_1	*
basilides_n	m
basiliscus_n	m
basilus_n	m
basiolum	n
basis	m
basium	n
bassaris_n	f
bassus_n	*
bastarnae_n	m
bataui_n	*
batauodurum_n	n
bathyllus_n	m
battiades_n	m
battus_n	m
batulum_n	n
baucis_n	f
bauius_n	*
bauli_n	*
bazaira_n	???
beatitudo	f
beatum	???
bedriacum_n	n
belgae_n	m
belgica_n	f
belgium_n	n
belica_n	2
belides_n	m
belides_n	m
belis_n	m
belitae_n	m
belius_n	4
bellator	m
bellatrix	f
bellerophontes_n	m
bellerophontes_n	m
bellica_n	f
bellicum	n
bellienus_n	???
bellona_n	f
bellouaci_n	*
bellua	???
bellum	n
bellum_n	n
bellus_n	*
belua	f
belus_n	m
benacus_n	m
benedictum	n
benefactum	n
beneficentia	f
beneficiarius_1	*
beneficium	n
beneuentum_n	n
beneuolentia	f
benignitas	f
benignus_n	*
berbex	???
berecyntia_n	???
beroea_n	f
berones_n	2
beryllus	*
berytus_n	f
bes	m
bessi_n	*
bessus_n	*
bestia	m
bestiarius_1	m
bestia_n	m
bestius_n	*
betaceus_1	*
beta_1	f
betilienus_n	4
betis_n	f
betuus_n	4
biae_n	2
bianor_n	m
bias_n	m
bibaculus_n	m
biberarius	m
bibliopola	m
bibliotheca	f
bibracte_n	n
bibrax_n	f
bibroci_n	*
bibula_n	???
bibulus_n	m
biclinium	n
bicorniger_n	m
bidens_1	f
bidental	n
bidini_n	???
bidis_n	???
biduum	n
biennium	n
bifurcum	n
biga	f
bigerriones_n	m
biiugi	???
bilis	*
bimaritus	*
bimembres_n	???
bingium_n	n
binoctium	n
bipalium	n
bipennis_1	*
bipes_1	*
biremis_1	*
birrius_n	*
bisaltae_n	m
bison	m
bissacius	4
bistones_n	m
bistonides_n	f
bithus_n	m
bithynia_n	f
bithynicus_n	masculin
bithynis_n	???
bithyni_n	*
bitias_n	m
biton_n	???
bittius_n	*
bitumen	n
bituriges_n	m
biuium	n
biuius_n	m
blaesus_n	*
blandimentum	n
blanditia	f
blanditia_n	f
blandus_n	*
blatta	f
blepharon_n	n
blesamius_n	m
bliteum	neutre
blitius_n	*
blossius_n	*
boccar_n	m
bocchoris_n	m
bocchus_n	m
boculus_n	m
bodotria_n	f
boduognatus_n	m
boeotia_n	f
boeotii_n	*
boeoti_n	*
boethus_n	m
bogud_n	m
boia	f
boihaemum_n	n
boii_n	*
boiocalus_n	m
bolanus_n	*
bola_n	f
boletatio	f
boletus	m
bolus	m
bombus	m
bombyx	2
bomilcar_n	m
boni	m
bonitas	f
bonna_n	f
bononia_n	f
bonum	n
bootes_n	m
boreas_n	m
boresti_n	*
borysthenes_n	m
borysthenidae_n	???
bos	m
bosphorus_n	???
bosporani_n	???
bosporus_n	m
bostar_n	m
bos_n	m
bottiaei_n	???
botularius	m
botulus	m
boudicca_n	f
bouianum_n	n
bouile	n
bouillae_n	f
boumelus_n	m
boxus_n	m
braca	m
brachiolum	n
brachium	n
bractea	f
bracteola	f
branchidae_n	m
brannouices_n	m
brassica	f
bratuspantium_n	n
brennus_n	m
breue_1	n
breuiarium	n
breuitas	f
breuni_n	*
brigantes_n	m
briganticus_n	m
brinno_n	m
brisaeus_n	m
briseis_n	f
britannia_n	f
britannicus_n	*
britanni_n	*
britto_n	m
brixellum_n	n
brixia_n	f
brocchus_n	m
brochubelus_n	4
brogitarus_n	m
bromia_n	???
bromius_n	*
brontes_n	m
bructeri_n	*
bruma	f
brundisini_n	???
brundisium_n	n
bruttedius_n	???
bruttiani_n	???
bruttianus_n	masculin
bruttidius_n	*
bruttii_n	*
brutus_n	m
bubacene_n	f
bubile	???
bubo	m
bubula	f
bubulcus	m
bucca	2
buccillus_n	4
bucco	m
buccula	f
bucephalas_n	f
bucephala_n	f
bucina	m
bucinator	m
bucinus	m
bucula	f
bufo	m
bulbus	*
bulbus_n	*
buleuta	m
bulidenses_n	3
bulla	f
bullatius_n	*
bumastus	*
bupalus_n	m
burdo_n	m
burdubasta	m
buris	m
buri_n	*
burrienus_n	???
burrus_n	*
bursauonenses_n	3
busiris_n	m
bustum	n
buta_n	m
buthrotum_n	n
butra_n	m
buxum	n
buxus	*
byllidenses_n	???
byllis_n	f
byrsa_n	f
byzantii_n	???
byzantium_n	n
caballus	m
cabera_n	f
caburus_n	???
caccabus	m
cachinnus	m
cacoethes	n
cacumen	n
cacurius_n	m
cacus_n	m
cadauer	n
cadius_n	*
cadmeis_n	f
cadmus_n	m
cadra_n	f
caduceator	m
caduceus	*
caducifer_n	m
caducum	n
cadurci_n	*
cadurcum	n
cadus	m
cadusii_n	*
caecilianus_n	???
caecilia_n	f
caecilius_n	*
caecina_n	m
caecitas	f
caecubum_n	n
caeculus_n	m
caecus_n	m
caedes	???
caedicia_n	2
caedicius_n	*
caedicus_n	m
caelator	m
caelatura	f
caelestes	???
caelestia	???
caeles_1	m
caeles_n	m
caelianus_n	*
caelibatus	m
caelicola	2
caeliculus_n	???
caelites	3
caelius_n	*
caelum_1	n
caelum_2	n
caelus	m
caemani_n	*
caementum	n
caenina_n	f
caenum	n
caepa	f
caeparius_n	*
caepasius_n	*
caepio_n	m
caeracates_n	m
caere_n	n
caerimonia	f
caerosi_n	*
caerula	???
caeruleum	n
caesarea_n	f
caesariani_n	m
caesaries	f
caesar_n	m
caesellius_n	*
caesennia_n	2
caesennius_n	*
caesernius_n	*
caesetius_n	4
caesianus_n	4
caesilianus_n	4
caesius_n	*
caesonia_n	???
caesoninus_n	???
caesonius_n	*
caeso_n	m
caespes	???
caestus	m
caetra_n	m
caetronius_n	???
cafo_n	m
caicus_n	m
caieta_n	f
caius_n	*
calabria_n	f
calacte_n	f
calactini_n	???
calagurritani_n	3
calais_n	m
calamister	m
calamistrum	n
calamis_n	f
calamitas	f
calamus	m
calathiscus	m
calathus	m
calatinus_n	*
calauius_n	*
calautica	f
calcar	n
calcarius_1	m
calceamentum	n
calceolarius	m
calceus	m
calchas_n	m
calcitro_1	
calculus	m
calda	2
caldarium	???
caldicerebrius	*
caledonia_n	f
calenum_n	n
calenus_n	*
calestrius_n	*
cales_n	f
caletes_n	???
caleti_n	*
calgacus_n	4
caliculus	m
calida	f
calidius_n	*
calidum	n
caliendrum	n
caliga	f
caligo_1	f
caligula_n	m
calix	m
callicrates_n	m
callidama_n	???
calliditas	f
callidromus_n	m
callimachus_n	m
calliopea_n	f
calliope_n	f
calliphana_n	???
calliphon_n	???
callis	2
callisthenes_n	m
callistratus_n	m
callistus_n	m
callum	???
calor	m
calo_1	m
calpetus_n	???
calpurnianus_n	*
calpurnia_n	2
calpurnius_n	*
caltha	f
calthula	f
caluae	f
caluentius_n	???
caluia_n	2
caluina_n	???
caluinius_n	4
caluinus_n	m
caluisius_n	???
caluities	f
calumnia	2
calumniator	m
calusidius_n	???
caluus_n	m
calx_1	f
calx_2	f
calydnae_n	2
calydon_n	f
camarina_n	f
cambyses_n	m
camella	f
camelus	m
camena	???
camenae_n	f
camena_n	???
camera	f
camerinum_n	n
camerinus_n	???
camerium_n	???
camerius_n	*
camertes_n	???
camilla_n	f
camillus_n	*
caminus	m
cammarus	???
campania_n	f
campani_n	*
campanus_n	*
campestre	n
campestria	n
campus_1	m
campus_n	m
camulodunum_n	n
camulogenus_n	???
camurius_n	4
camurtius_n	4
canale	n
canalis_1	f
cancellus	m
cancer	m
cancer	m
cancer_n	m
cancer_n	m
candauia_n	f
candela	f
candelabrum	n
candelabrus	m
candidatus_1	m
candidus_n	m
candor	m
cani	m
canicula	f
canicula_n	f
canidia	???
canidia_n	???
caninius_n	*
caninus_n	*
canis	m
canistra	n
canistrum	n
canis_n	m
canities	f
canius_n	*
canna	f
cannabis	f
cannae_n	f
canninefates_n	???
cannutius_n	???
canopitae_n	m
canopus_n	m
canor	m
cantabri	*
cantabri_n	*
cantamen	n
canterius	m
canthara_n	f
cantharis	f
cantharus	m
canthus	m
canticum	n
cantilena	f
cantio	f
cantium_n	n
cantor	m
cantus	m
canuleius_n	*
canusium_n	n
canus_n	*
canutius_n	???
capaneus_n	m
capax_n	*
capella	2
capella_n	2
capena_n	f
caper	m
capillamentum	n
capillus	???
capis	f
capistrum	???
capital	n
capito	m
capitolinus_n	*
capitolium_n	n
capito_n	m
capitulum	n
capo	m
cappadoces_n	m
cappadocia_n	f
cappadox_a	???
capparis	m
capra	f
capra_n	f
caprea	f
capreae_n	f
capreida	f
capreolus	m
capricornus	m
capricornus_n	m
caprificus	f
caprimulgus	m
caprius_n	*
capsa	f
capsa_n	f
capsella	f
capsenses_n	???
capsula	f
captator	m
captio	f
captiua	f
captiuitas	f
captiuus_1	*
captus	m
capua_n	f
capulator	m
capulus	m
caput	n
capys_n	m
carales_n	f
caralitani_n	???
caranus_n	m
caratacus_n	???
cara_n	f
carbasa	2
carbasus_1	m
carbo	m
carbonarius_1	*
carbo_n	m
carbunculus	m
carcaso_n	f
carcer	m
carchesium	n
cardiacus_1	*
cardo	m
carduelis	m
carduus	m
carectum	n
carene_n	???
carene_n	???
carex	f
carfinia_n	2
carfulenus_n	*
caria_n	f
carica	f
carina	f
carinae_n	f
carinarius	m
carina_n	f
cario_n	m
caris	f
caristia_n	n
caritas	f
carmania_n	f
carmani_n	*
carmelus_n	m
carmentis_n	???
carmen_1	n
carmen_2	n
carmo	m
carmonenses_n	???
carmo_n	m
carnarium	n
carna_n	f
carneades_n	m
carnifex	m
carnificina	f
carnutes_n	m
caro_1	m
carpatina	???
carpentum	n
carpinatius_n	???
carpinus	m
carpophorus_n	*
carptor	m
carpus_n	m
carrinas_n	f
carruca_n	f
carrum	n
carrus	???
carseoli_n	m
carsidius_n	m
carsulae_n	f
carsulanum_n	???
carteia_n	f
carteienses_n	3
carthaginienses_n	???
carthago_n	f
cartimandua_n	???
caruilius_n	*
carus_n	*
caryota	f
carystus_n	f
casa	f
casca_n	f
cascellius_n	*
cascus_n	m
caseum	???
caseus	m
casia	f
casilinum_n	n
casina_n	f
casinum_n	n
casinus_n	masculin
casmilla_n	???
casperia_n	f
casperius_n	*
caspiae_n	f√©minin
caspii_n	*
cassander_n	m
cassandra_n	f
cassiani_n	masculin
cassida	f
cassis_1	f
cassis_2	f
cassiuellaunus_n	???
cassius_n	*
cassi_n	*
cassum	n
castabalus_n	4
castalia_n	f
castanea	f
casta_n	f
castellani	m
castellum	n
casteria	f
casticus_n	m
castigatio	f
castigator	m
castimonia	f
castitas	f
castoreum	n
castor_n	m
castra_1	n
castra_2	n
castra_n	n
castricius_n	*
castrum_n	n
casula	f
casus	*
catamantaloes_n	3
catamitus	m
catamitus_n	m
catanes_n	3
cataphagas	m
cataphracta	f
cataphractus	masculin
catapirateria	f
cataplasma	n
cataplexis	f
cataplus	m
catapulta	f
cataracta	f
catascopus	m
catasta	f
catastropha	???
cateia	f
catella_1	f
catella_2	f
catellus	m
catena	f
catenatio	f
caterua	f
cathedra	f
cathegus_n	4
catia_n	???
catiena_n	???
catienus_n	???
catilina_n	m
catillum	???
catillus	4
catillus_n	4
catilus_n	???
catina_n	f
catinenses_n	???
catinum	???
catinus	m
catius_n	*
catonius_n	4
cato_n	m
catualda_n	???
catula	f
catulinus_n	*
catulla_n	???
catullus_n	m
catulus	m
catulus_n	m
caturiges_n	m
catus_n	m
catuuolcus_n	4
cauaedium	n
cauarillus_n	4
cauarinus_n	???
caucasus_n	m
caucilius_n	4
cauda	f
caudex	m
caudex_n	m
caudinus_n	*
caudium_n	n
cauea	f
cauerna	f
cauilla	f
cauillatio	f
cauillator	m
cauillonum_n	n
caula	f
cauliculus	m
caulis	m
caulius_n	*
caulon_n	???
caunea	2
caunii_n	???
caupo	m
caupona	f
cauponula	f
caurus	m
caurus_n	m
causa	f
causidicus	m
causinius_n	4
causula	f
cautes	m
cautio	f
cautor	m
cauum	???
cauus_1	*
caycus_n	m
caystrus_n	???
cea_n	f
cebalinus_n	4
cebenna_n	m
cecropia_n	f
cecropidae_n	2
cecropidae_n	2
cecrops_n	m
cedra	f
cedrosia_n	2
cedrosii_n	3
cedrus	f
ceius_n	*
celadus_n	m
celaenae_n	f
celebratio	f
celebritas	f
celemna_n	???
celendris_n	???
celeritas	f
celer_n	m
celeus_n	m
cella	f
cellarius_1	m
cellatio	f
cellula	f
celox	2
celsus_n	*
celtae_n	m
celtiberia_n	f
celtiberi_n	*
celtillus_n	???
cena	f
cenabenses_n	3
cenabum_n	n
cenaculum	n
cenatio	f
cenatiuncula	f
cenatoria	n
cenchreus_n	m
cenimagni_n	*
cenomani_n	*
censio	f
censor	m
censorinus_n	*
censorius_1	*
censorius_n	*
censura	f
census	*
centaureum	n
centauromachia_n	???
centaurus	m
centaurus_n	m
centesima	f
cento	m
centonarius_1	m
cento_n	m
centumalus_n	m
centumcellae_n	f
centumpondium	n
centumuir	???
centunculus	m
centuria	f
centuriatus_1	m
centurionatus	m
centurio_1	m
centuripini_n	???
centussis	m
cenula	f
ceparius_n	m
cephallenes_n	???
cephaloeditani_n	???
cephaloedium_n	n
cephalus_n	m
cephenes_n	m
cepheus_n	m
cera	f
cerarium	n
cerastes	m
cerasum	n
cerasus	f
ceraunia_n	n
ceraunii_n	masculin
cerberus_n	m
cercetae_n	m
cercina_n	f
cercinitani_n	???
cercius_n	*
cercopithecus	m
cerdo	m
cerdo_n	m
cerealia_n	n
cerebellum	n
cerebrum	???
ceres	f
ceres_n	f
cereus_1	m
cerialia_n	???
cerintha	f
cerinthus_n	m
ceroma	f
certamen	n
certatio	f
certum_1	n
certus_n	*
cerua	f
ceruarius_n	*
ceruical	n
ceruicula	f
ceruius_n	*
ceruix	f
cerussa	f
ceruus	m
ceryx	m
cessator	m
cestilius_n	4
cestius_n	*
cetarini_n	???
cetarium	n
cetarius	m
cetera_1	???
ceteri	masculin
ceterum_1	???
cethegus_n	m
cetra	m
cetrati	m
cetrius_n	*
cetus	f
ceutrones_n	m
ceyx_n	m
chaerea_n	m
chaerestratus_n	m
chaeribulus_n	m
chaerippus_n	m
chaeronea_n	f
chalcedonii_n	???
chalcis_n	f
chaldaei_n	*
chaldaeus_n	masculin
chaldei_n	3
chalinus_n	m
chalybes_n	m
chalybs	m
chamaui_n	*
chaonia_n	f
chaon_n	m
chaos	n
chaos_n	n
chara	f
charaxus_n	m
chares_n	m
charicles_n	m
charidemus_n	m
charinus_n	m
charioualda_n	???
charis_n	f
charites_n	3
charondas_n	m
charta	f
charus_n	masculin
charybdis_n	???
chasuarii_n	*
chatti_n	*
chauci_n	*
chele_n	f
chelidon_n	f
chelydrus	???
cheragra	f
chersonesus_n	f
cherusci_n	*
chia_n	f
chii_n	3
chiliarches	m
chilo_n	m
chimaera_n	f
chiragra	f
chiragrici	???
chiramaxium	n
chirographum	n
chius_n	*
chlamys	f
chloris_n	f
chlorus_n	m
choaspes_n	m
chobus_n	???
choerilus_n	m
choragium	n
chorasmii_n	*
choraula	2
chorda	f
chorea	f
chorus	m
chremes_n	m
chria	f
christianus_1	*
christianus_n	*
christus_n	m
chromis	m
chromis_n	m
chrysalus_n	???
chrysanthus_n	m
chrysas_n	m
chryses_n	f
chrysippus_n	m
chrysis_n	f
chrysogonus_n	m
chrysolithus	m
chrysos	m
cibarium	n
cibatus	m
ciborium	n
cibus	m
cibyrata_n	2
cibyra_n	f
cicada	2
cicaro	m
cicatrix	f
cicer	n
cicero_n	m
cichorium	n
cicirrus_n	m
cicones_n	m
ciconia	f
cicuta	m
cicuta_n	m
cidaris	f
cietae_n	???
cilices_n	m
cilicia_n	f
cilicium	n
cilla_n	f
cilnius_n	*
cilo_n	m
cimberius_n	4
cimber_n	*
cimbri_n	*
cimex	m
ciminus_n	*
cimon_n	m
cinaedus_1	m
cinara_n	f
cincinnatus_n	m
cincinnus	m
cincticulus	m
cineas_n	m
cinerarius_1	m
cinga_n	m
cingetorix_n	m
cingillum	???
cingonius_n	*
cingula	f
cingulum	n
cingulum_n	n
ciniflo	m
cinipes	3
cinis	f
cinithii_n	???
cinnamum	n
cinnamus_n	m
cinna_n	m
cinnus	m
cinyras_n	m
cinyra_n	m
cinyrus_n	4
cippus	m
circeii_n	*
circenses	m
circe_n	f
circinus	m
circitor	m
circuitus	m
circulator	m
circulus	m
circumactus	m
circumcaesura	f
circumductio	f
circumlitio	f
circummunitio	f
circumscriptio	f
circumscriptor	m
circumsessio	f
circumspectatrix	f
circumspectus_1	m
circus	m
circus_n	m
cirrati	m
cirrha_n	???
cirrus	m
cirta_n	f
cirtenses_n	???
cisium	n
cispius_n	*
cisseis_n	f
cista	f
cistellula	f
cisterna	f
cistophorus	m
cistula	f
cita_n	m
citeria	f
cithaeron_n	m
cithara	f
citharista	m
citharoedus	m
citrum	n
ciuica	f
ciuica_n	f
ciuilis_n	m
ciuis	m
ciuitas	f
ciuitatula	f
clades	f
clamor	m
clangor	m
clanis_n	m
clanius_n	*
claranus_n	m
claritas	f
claritudo	f
clarius_n	???
clarus_n	*
classiarii	m
classici	m
classicianus_n	4
classicum	n
classicus_n	m
classis	f
claterna_n	f
clathra	2
clathri	m
claua	f
clauarium	n
claudia_n	f
claudiopolitani_n	???
claudius_n	*
clauicula	???
clauis	f
claustrum	n
clausula	f
clausum	n
clausus_n	*
clauulus	m
clauus	m
clazomenae_n	f
cleander_n	m
cleanthes_n	m
cleareta_n	2
clemens_n	m
clementia	f
cleobula_n	f
cleomachus_n	m
cleombrotus_n	m
cleomenes_n	m
cleomenes_n	m
cleonae_n	f
cleonicus_n	*
cleon_n	m
cleopatra_n	f
cleophantus_n	m
cleophis_n	f
clepsydra	f
cleustrata_n	2
clibanus	m
cliens	m
clienta	f
clientela	f
clientulus	m
clinamen	n
cliniades_n	m
clinia_n	m
clipeatus_1	*
clipeum	???
clipeus	m
clitarchus_n	m
clitellae	f
clitumnus_n	m
clitus_n	m
cliuum	???
cliuus	m
cloaca	f
cloacina_n	f
cloanthus_n	m
clodianus_n	*
clodia_n	???
clodius_n	*
cloelia_n	???
cloelius_n	*
clonius_n	m
clonus_n	f
clostellum	???
clota_n	f
cluentia_n	???
cluentius_n	*
clunis	f
clupeae_n	f
clupea_n	f
clusinas_n	2
clusium_n	n
clusius_n	*
clustumina_n	f
clutorius_n	*
cluuiae_n	f
cluuia_n	???
cluuidienus_n	???
cluuienus_n	???
cluuius_n	*
clymenus_n	m
clytaemestra_n	f
clytaemnestra_n	f
clytius_n	*
cneus_n	???
cnidii_n	???
cnidus_n	m
coaceruatio	f
coacta	n
coactio	f
coactor	m
coactus	m
coagmentum	n
coagulum	n
coartatio	f
coa_n	2
cobiamachus_n	m
cocceianus_n	*
cocceius_n	*
coccum	n
cochlea	f
cochleare	n
cocio	f
cocles_n	m
cocosates_n	m
coctor	m
coctura	f
coculum	n
cocytus_n	m
codex	m
codicillus	m
codrus_n	m
coelaletae_n	m
coelius_n	*
coemptio	f
coenus_n	m
coeptum	n
coeranus_n	*
coercitio	f
coetus	m
coeus_n	m
cogidumnus_n	4
cogitatio	f
cogitatum	n
cognatio	f
cognatus_1	m
cognitio	f
cognitor	m
cognomen	n
cognomentum	n
coheres	*
cohors	f
cohortatio	f
coitio	f
coitus	m
coi_n	???
colaphus	m
colaphus_n	m
colchis_n	f
colchi_n	m
coleus	m
coliphium	n
collare	n
collatia_n	f
collatinus_n	*
collatio	f
collator	m
collatus	m
collaudatio	f
collectio	f
collectus_1	m
collega	m
collega_n	m
collegium	n
collibertus	m
colligatio	f
collis	m
collocatio	f
collocutio	f
colloquium	n
colluctatio	f
collum	n
collus	m
collusio	f
collusor	m
colluuies	f
colluuio	f
collybus	m
collyrium	n
colocasium	n
colocyntha	f
colonia	f
colonia_n	f
colonus_1	*
colophonii_n	???
colophon_n	f
color	m
colossus	m
coluber	m
colubra	f
colum	n
columba	f
columbulus	m
columbus	m
columella	f
columen	n
columna	f
columnarium	n
colus	m
colus	m
colus	m
coma	2
comana_n	n
comarchus	m
comes	m
cometa_n	f
cometes	m
comicus_1	*
cominius_n	*
comissatio	f
comissator	m
comitas	f
comitatus_1	m
comitia	f
comitium	n
commageni_n	???
commanipularis	*
commaritus	m
commeatus	m
commemoratio	f
commendatio	f
commendator	m
commentariolus	m
commentarius_1	m
commentor_1	m
commentum	n
commercium	n
commigratio	f
commilitium	n
commilito_1	m
comminatio	f
commis	m
commissio	f
commissum	n
commissura	f
commius_n	???
commoditas	f
commodum_1	n
commune	n
communicatio	f
communio_1	f
communitas	f
commutatio	f
commutatus	m
comoedia	f
comoedus_1	*
compactum	n
compages	m
compago	f
comparatio_1	f
comparatio_2	f
compar_1	*
compedes	???
compellatio	f
compendiaria	f
compendiarium	n
compendium	n
compensatio	f
comperendinatio	f
comperendinatus	m
compes	m
competitor	m
competitrix	f
compitalia	neutre
compitalia_n	neutre
compitum	n
complementum	n
complexio	f
complexus	m
comploratio	f
complures_1	*
compositio	f
compositum	n
compositura	f
compotatio	f
compotor	m
compransor	m
comprehensio	f
compressus_1	m
compromissum	n
compsani_n	???
compsa_n	f
comptus_1	m
computatio	f
computator	m
comula	f
comum_n	n
conamen	n
conata	n
conatus	m
concaedes	f
concenatio	f
concentio	f
concentus	m
conceptus_1	m
concertatio	f
concertator	m
concessio	f
concessum	???
concessus	m
concha	f
conchis	f
conchylium	n
conciliabulum	n
conciliatio	f
conciliator	m
conciliatricula	f
conciliatrix	f
conciliatura	f
conciliatus	m
concilium	n
concinnitas	f
concisura	f
concitamentum	n
concitatio	f
concitator	m
concitor	m
conclamatio	f
conclaue	n
conclusio	f
conconnetodumnus_n	4
concordia	f
concordia_n	f
concubina	f
concubinus	m
concubitus	m
concupitor	m
concursatio	f
concursus	m
concussio	f
concussus	m
condemnatio	f
condemnator	m
condicio	f
condictor	m
condimentum	n
condiscipulus	m
conditiuum	n
conditorium	n
conditor_1	m
conditura_1	f
conditura_2	f
condonatio	f
condrusi_n	m
conductio	f
conductor	m
conductum	n
confectio	f
confector	m
confessio	f
confessum	n
confictio	f
confidentia	f
confinium	n
confirmatio	f
confirmator	m
conflictus	m
confluens	m
conformatio	f
confragosum	???
confusio	f
conger	???
congeries	f
congestus_1	m
congiarium	n
congius	*
conglobatio	f
conglutinatio	f
congregatio	f
congressio	f
congressus	m
congrio_n	m
congruentia	f
congus_n	m
coniectio	f
coniector	m
coniectura	f
coniectus	m
coniugator	m
coniugium	n
coniunctio	f
coniunctum	n
coniurati	3
coniuratio	f
coniux	???
connexus_1	m
connubium	???
conon_n	m
conopeum	???
conopium	n
conquestio	f
conquisitio	f
conquisitor	m
consaeptum	n
consalutatio	f
consanguinea	f
consanguinei	???
consanguineus_1	*
consanguinitas	f
conscientia	f
conscriptio	f
consecratio	f
consectatio	f
consectatrix	f
consensio	f
consensus	m
consequens_1	n
conserua	f
conseruatio	f
conseruator	m
conseruator_n	m
conseruitium	n
conseruus_1	???
consessor	m
consessus	m
considium	n
considius_n	*
consiliarius_1	*
consiliator	m
consilium	n
consitio	f
consitor	m
consobrina	f
consobrinus	m
consociatio	f
consolatio	f
consolator	m
consortio	
consortium	n
conspectus_1	m
conspicuum	neutre
conspiratio	f
constantia	f
consternatio	f
constitutio	f
constitutum	n
constratum	n
constructio	f
consuasor	m
consuetio	f
consuetudo	f
consul	m
consularis_1	m
consulatus	m
consultatio	f
consultor	m
consultum	n
consummatio	f
consurrectio	f
consus_n	m
contabulatio	f
contactus	m
contages	f
contagio	
contagium	n
contemplatio	f
contemplator	m
contemptio	f
contemptor	m
contemptrix	f
contemptus_1	*
contentio_1	f
contentio_2	f
conterminum	n
contextus_1	m
conticinium	n
contignatio	f
contignatum	n
continens_1	m
continentia	f
continuatio	f
contio	f
contionator	m
contractio	f
contractus_1	m
contradictio	f
contrarium	n
controuersia	f
contubernalis	*
contubernium	n
contuitus	m
contumacia	f
contumelia	f
contus	m
conuallis	f
conuena	2
conuenientia	f
conuenticulum	n
conuentio	f
conuentum	n
conuentus	m
conuersatio	f
conuersio	f
conuexum	n
conuiciator	m
conuicium	n
conuictolitauis_n	m
conuictor	m
conuictus	m
conuiua	m
conuiuator	m
conuiuium	n
conuocatio	f
conuoluulus	m
conus	m
cooptatio	f
coortus	m
cophinus	m
copia	f
copia_n	f
copis	f
coponius_n	masculin
coptoplacenta	f
coptus_n	f
copula	f
coquus	m
cor	m
coranus_n	*
corax_n	m
cora_n	f
corbis	m
corbita	f
corbula	f
corbulo_n	m
corcillum	n
corculum	n
corcyra_n	f
cordalio_n	???
cordalus_n	4
cordax	*
cordoba_n	2
corduba_n	f
cordubenses_n	???
cordus_n	m
corellia_n	2
corellius_n	*
corfidius_n	*
corfinienses_n	???
corfinium_n	n
coriandrum	n
corinna_n	f
corinthia_n	2
corinthii_n	???
corinthium_n	neutre
corinthus_n	2
coriolanus_n	*
coriosolites_n	m
corium	n
corma_n	f
cornelia_n	???
cornelius_n	*
cornicen	m
cornicula	f
cornificius_n	*
cornipes_1	m
cornix	f
cornu	n
cornum_1	n
cornum_2	n
cornus	m
cornutus_n	*
coroebus_n	m
corolla	f
corollarium	n
corona	m
coronamentum	n
corona_n	m
coronis_n	f
corpus	n
corpusculum	n
correctio	f
corrector	m
correus_n	m
corruda	f
corruptela	f
corruptio	f
corruptor	m
corsica_n	f
corsi_n	*
cortex	m
cortina	f
coruinus_n	*
coruncanius_n	*
coruus	m
coruus_n	m
corybantes_n	m
corycus	*
corydon_n	m
coryletum	n
corylus	f
corymbium	???
corymbus	m
corynaeus_n	???
coryphaeus_n	m
corythus_n	m
corytus	m
cos	m
cosanum_n	???
cosa_n	f
cosconius_n	m
cosmeta	2
cosmus_n	m
cossaei_n	3
cossinius_n	???
cossus_n	m
cossutianus_n	???
cossutius_n	*
costa	2
costa_n	2
costum	n
cosyra_n	???
cotes	
cothon	m
cothurnus	m
cotini_n	*
cotiso_n	m
cottana	n
cotta_n	m
cottius_n	???
cotuatus_n	4
coturnix	f
cotus_n	m
cotyla	m
cotyla_n	m
cotys_n	m
cotys_n	m
cotytia	2
couinnarius	m
coum	???
cous_n	*
coxa	f
coxendix	f
crabra_n	???
crabro	m
cragus_n	m
crannon_n	m
crantor_n	m
crapula	f
crassicius_n	*
crassitudo	f
crassus_n	m
crastinum	n
crastinus_n	*
cras_1	
crater	m
cratera	f
craterus_n	m
crates	m
crathis_n	m
craticula	f
cratinus_n	*
cratippus_n	m
creator	m
creatrix	f
crebritas	f
creditor	m
creditum	n
credulitas	f
cremera_n	f
cremona_n	f
cremonenses_n	???
cremor	m
cremutius_n	*
creon_n	m
crepereius_n	*
crepida	f
crepido	f
crepitacillum	n
crepitus	m
crepusculum	n
crescens_n	m
cressa_n	f
creta	f
cretanus_n	???
creta_n	f
cretenses_n	???
cretes_n	m
creticus_n	*
cretula	f
creusa_n	f
cribrum	n
crimen	n
criminatio	f
criminator	m
crinis	m
crinisus_n	m
crispina_n	???
crispinilla_n	2
crispinus_n	*
crispus_n	*
crista	m
critica	n
criticus_1	*
critobulus_n	m
critognatus_n	m
critolaus_n	m
crocinum	n
crocodilus	m
crocota	f
crocotula	f
crocum	n
crocus	m
crodunum_n	???
croesus_n	m
crotalia	n
crotalistria	f
crotoniates_n	m
croton_n	f
cruciamentum	n
cruciarius_1	*
cruciatus	m
crucisalus_n	???
crudelitas	f
cruditas	f
crumena	f
cruor	m
cruppellarii	???
cruptorix_n	???
crus	m
crusta	f
crustularius	m
crustulum	n
crustum	n
crustumeri_n	???
crustuminum_n	???
crux	*
crypta	f
cryptoporticus	f
crystallina	???
crystallum	???
crystallus	???
cubicularius_1	*
cubiculum	n
cubile	n
cubital	n
cubitum	n
cubitus_1	m
cubitus_2	m
cubus	m
cucullio	m
cucullus	m
cuculus	m
cucuma	2
cucumis	???
cucumula	f
cucurbita	f
cugerni_n	*
culcita	f
culeum	n
culeus	masculin
culex	???
culigna	f
culina	f
culmen	n
culmus	m
culpa	f
culta	f
cultellus	m
culter	m
cultio	f
cultor	m
cultrix	f
cultura	f
cultus_1	*
culullus	f
culus	m
cumae_n	f
cumani_n	???
cumanus_n	*
cumbula	f
cumera	f
cuminum	n
cumulus	m
cunabula	n
cunae	f
cunctatio	f
cunctator	m
cuneus	m
cunica	f
cuniculus	m
cunnus	m
cupauo_n	m
cupa_1	f
cupa_2	f
cupedium	???
cupedo	f
cupencus_n	m
cupiditas	f
cupido	*
cupido_n	*
cupiennius_n	*
cupitor	m
cupitum	???
cupressetum	n
cupressus	m
cupressus	m
cupressus	m
cupula_2	f
cura	f
curatio	f
curator	m
curatura	f
cura_n	f
curculio	m
curculio_n	m
cures_n	m
curetes_n	m
curia	f
curianus_n	masculin
curiatius_n	*
curia_n	f
curicta_n	???
curidius_n	???
curio	m
curio_n	m
curis	f
curius_n	*
curriculum	n
currus	m
cursor	m
cursor_n	m
cursura	f
cursus	m
curtilius_n	*
curtillus_n	4
curtisius_n	4
curtius_n	*
curuamen	n
curuatura	f
cusinius_n	???
cuspis	f
custodia	f
custos	m
custos_n	m
cusus_n	m
cuticula	f
cutis	m
cutius_n	*
cyaneae_n	f
cyathus	m
cybaea	f
cybebe_n	f
cybelus_n	m
cyclades_n	f
cyclas	f
cyclas_n	f
cyclopes_n	m
cyclops_n	m
cycnus	m
cycnus_n	m
cydas_n	m
cydnus_n	m
cydonium_n	neutre
cylindrus	m
cyllarus_n	m
cyllena_n	???
cyllenius_n	???
cymba	???
cymbalistria	f
cymbalum	n
cymbium	n
cymodocea_n	f
cynici_n	*
cynosura_n	f
cynthia_n	f
cynthius_n	???
cynthus_n	*
cyparissus	m
cypassis_n	f
cypria_n	n
cyprii_n	*
cyprus_n	f
cyrenae_n	f
cyrenaici_n	???
cyrenenses_n	???
cyropolis_n	f
cyrrus_n	???
cyrsilus_n	???
cyrus_n	m
cytaeis_n	f
cythera_n	n
cytherea_n	???
cythnus_n	f
cytisus	m
cytorus_n	m
cyziceni_n	???
cyzicus_n	f
d	2
dabar_n	m
dacia_n	f
dacicus_n	???
daci_n	*
daedala_n	f
daedalus_n	m
dahae_n	m
dalmatae_n	m
dalmatia_n	f
dama	m
damalis_n	f
damascus_n	f
damasippus_n	m
dama_n	m
damma	f
damnatio	f
damnum	n
damoetas_n	m
damon_n	???
danaidae_n	m
danai_n	*
danaus_n	*
dandarica_n	f
dandaridae_n	???
danista	m
danubius_n	m
danuuius_n	m
daphnis_n	2
daps	???
dardania_n	f
dardani_n	*
dardanus_n	m
dares_n	m
dareus_n	m
dataphernes_n	m
datio	
dator	m
datum	n
dauara_n	f
daulis_n	f
daunus_n	*
dauus_n	m
dea	f
dea_n	f
debellator	m
debens	???
debilitas	f
debilitatio	f
debitio	f
debitor	m
debitum	n
decangi_n	3
december_n	m
decempeda	f
decempedator	m
decemuir	???
decemuiratus	???
decentia	f
deceptor	m
decertatio	f
decessio	f
decessor	m
decessus	m
decetia_n	f
decianus_n	*
decibalus_n	???
decidiana_n	2
decidius_n	*
decima	f
decimani	???
decimanus_1	m
decimius_n	*
decimus_n	*
decisio	f
decius_n	*
declamatio	f
declamator	m
declaratio	f
declarator	m
declinatio	f
decliue	n
decliuitas	f
decocta	f
decoctor	m
decor	m
decorum	???
decor_n	m
decretum	n
decrius_n	m
decuria	f
decuriatio	f
decurionatus	m
decurio_1	m
decursio	f
decursus	m
decus	m
dedecus	n
dedicatio	f
dedignatio	f
dediticius_1	*
deditio	f
deductio	f
deductor	m
defatigatio	f
defectio	f
defector	m
defectus_1	*
defensio	f
defensor	m
definitio	f
deflagratio	f
deformitas	f
defrutum	n
dehonestamentum	n
deianira_n	f
deidamia_n	f
deiectio	f
deiectus_1	m
deillius_n	???
deiopea_n	f
deiotarus_n	m
deiphobus_n	m
delatio	f
delator	m
delectamentum	n
delectatio	f
delectus	m
delegatio	f
delenimentum	n
deletrix	f
deliaci_n	masculin
delia_n	f
deliberatio	f
deliberator	m
delicatus_1	*
delicia_1	f
deliciolum	n
delicium	n
delictum	n
deliquio	f
deliramentum	n
deliratio	f
delius_n	*
dellius_n	m
delos_n	f
delphin	???
delphinus	m
delphi_n	m
delta_n	n
delubrum	n
demades_n	m
demaenetus_n	m
demaratus_n	m
demarchus	m
dementia	f
demetrius_n	*
demianus_n	4
deminutio	f
demissio	f
demochares_n	m
democritus_n	m
demodocus_n	m
demoleus_n	m
demolitio	f
demonstratio	f
demophilus_n	m
demophon_n	???
demosthenes_n	m
denarius_1	*
dens	m
denseletae_n	???
densus_n	m
dentale	n
dentatus_n	m
denter_n	m
dentifrangibulum	???
dentifrangibulus	*
denuntiatio	f
depeculator	m
depeculatus	m
depetigo	f
deploratio	f
depopulatio	f
depopulator	m
deportatio	f
depositum	n
deprauatio	f
deprecatio	f
deprecator	m
deprehensio	f
depugnatio	f
depulsio	f
depulsor	m
dercennus_n	m
derelictio	f
deridiculum	n
derisor	m
derisus	m
deriuatio	f
derupta	???
descensio	f
descensus	m
descripta	???
descriptio	f
deserta	f
desertor	m
desertum	n
desiderium	n
desidiabulum	n
desidia_1	???
designatio	f
designator	m
desipientia	f
despectus_1	m
desperatio	f
despicatus_1	m
despicientia	f
destillatio	f
destinatio	f
destinatum	n
destitutio	f
desuetudo	f
desultor	m
desultorius_1	*
detestatio	f
detractator	???
detractio	f
detractor	m
detrectatio	f
detrimentum	n
deucalion_n	m
deuersitor	m
deuersorium	n
deuerticulum	n
deuexitas	f
deuexum	???
deuia	f
deunx	m
deuoti	masculin
deuotio	f
deus	m
deus_n	m
dexamenus_n	m
dexithea_n	2
dexo_n	???
dextera	f
dexter_n	m
diabathrarius	m
diablintes_n	???
diabolus_n	m
diadema	n
diadematus_n	m
diaeta	f
dialectica	f
dialecticus_1	*
dialis_n	2
dialogus	m
diana_n	f
dianium_n	n
diaria	n
diarium	n
dia_n	f
dica	f
dicacitas	f
dicaearchus_n	m
dicatio	f
dicio	f
dicis	
dicrota	f
dictamnus	???
dictator	m
dictatura	f
dictio	f
dictum	n
dictynna_n	f
didius_n	*
didymaon_n	m
didymus_n	m
dies	f
diespiter_n	m
dies_n	f
differentia	f
differitas	f
difficultas	f
diffidentia	f
diffugium	n
diffusio	f
digentia_n	f
digitulus	m
digitus	m
dignatio	f
dignitas	f
digressus	m
diiunctio	???
dii_n	
dilatio	f
dilator	m
dilectus_1	m
diligentia	f
dillius_n	*
diluculum	n
diludium	n
diluuies	f
diluuium	???
dimachae	f
dimicatio	f
dimidium	n
diminutio	???
dimissio	f
dinaea_n	f
dindyma_n	n
dindymena_n	f
dindymus_n	*
dinia_n	f
dinomachus_n	m
diocles_n	m
diocles_n	m
diodorus_n	*
diodotus_n	*
diogenes_n	m
diognetus_n	m
diomedes_n	m
dione_n	f
dionysiarchus_n	4
dionysia_n	2
dionysia_n	2
dionysius_n	*
dionysodorus_n	m
dionysus_n	m
dion_n	m
diota	f
dioxenus_n	m
dioxippus_n	m
diphilus_n	m
diploma	n
dipondium	???
dipondius	4
dira	n
dirae	f
dira_n	n
directum_1	n
direptio	f
direptor	m
diribitio	f
diribitor	m
diritas	f
discens	m
disceptatio	f
disceptator	m
discessio	f
discessus	m
discidium	n
disciplina	f
discipula	f
discipulus	m
discordia	f
discordia_n	f
discrepantia	f
discrimen	n
discriptio	f
discursatio	f
discursus	m
discus	m
disiectus	m
dismaritus	m
dispectus	m
dispendium	n
dispensatio	f
dispensator	m
dispertitio	f
displicentia	f
dispositio	f
dispositum	n
dispositura	f
dispositus_1	m
disputatio	f
disputatiuncula	f
disputator	m
disquisitio	f
dissaeptum	n
dissensio	f
dissensus	m
dissignator	m
dissimilitudo	f
dissimulatio	f
dissimulator	m
dissipatio	f
dissociatio	f
dissolutio	f
dissuasio	f
dissuasor	m
distantia	f
distinctio	f
distinctus_1	m
distractio	f
distributio	f
disturbatio	f
dis_n	m
ditamenes_n	3
dithyrambus	m
ditis_n	???
diua	f
diua_n	f
diuerbium	???
diuersitas	f
diuersorium	neutre
diuersum	n
diuidia	f
diuinatio	f
diuina_1	f
diuina_2	f
diuinitas	f
diuinum	n
diuinus_1	m
diuisio	f
diuisor	m
diuitatio	f
diuitiacus_n	m
diuitiae	f
diuodurum_n	n
diuortium	n
diurnum	n
diuturnitas	f
diuulsio	f
diuum	n
diuus_1	*
docilis_n	m
docilitas	f
docimus_n	m
doctor	m
doctrina	f
documen	n
documentum	n
dodona_n	f
dogma	f
dolabella_n	m
dolabra	f
dolichaon_n	m
dolium	n
dolon	m
dolon_n	m
dolopes_n	m
dolops_n	m
dolor	m
dolor_n	m
dolus	m
domesticus_1	*
domicilium	n
domina	f
dominans_1	???
dominatio	f
dominator	m
dominatrix	f
dominatus	m
dominium	n
dominus	m
domitiani_n	???
domitianus_n	???
domitia_n	???
domitius_n	*
domitor	m
domitrix	f
domnilaus_n	4
domnotaurus_n	4
domus	f
domus	f
domus	f
domusio	f
donaria	n
donatio	f
donatius_n	4
donatiuum	n
donator	m
donum	n
donusa_n	f
dorcas	f
doris_n	f
dorotheus_n	*
dorsum	n
dorus_n	*
doryclus_n	m
dorylaeum_n	n
dorylaus_n	m
dorylenses_n	???
doryphora	2
doryphorus_n	m
dos	f
dossennus_n	m
dossenus_n	m
drachma	f
draco	m
dracon_n	m
drances_n	m
drangae_n	m
drapeta	m
drappes_n	m
drepanum_n	n
dromas	f
druida	???
druidae	m
druides	m
drusilla_n	???
drusus_n	m
dryades_n	f
dryantiades_n	m
dryas_n	m
dryopes_n	m
dryops_n	m
dubis_n	m
dubitatio	f
dubium	n
dubius_n	*
ducenius_n	*
ducentesima	f
ductor	m
ductus	*
duellator	m
duellius_n	masculin
duellum	n
duilius_n	*
dulcedo	f
dulce_1	neutre
dulgubini_n	3
dulichia_n	f
dulichii_n	masculin
dulichium_n	???
dumetum	n
dumnacus_n	???
dumnorix_n	m
dumus	m
duoetuicesimani	???
dupla	f
duplum	n
duramen	n
duramentum	n
duratius_n	m
duritia	f
durities	f
duritudo	f
durius_n	m
durocortorum_n	n
durum	???
durus_n	m
duumuir	???
duumuiratus	m
dux	m
dymnus_n	4
dynastes	m
dyrrachini_n	???
dyrrachium_n	n
dyspepsia	f
ebenus	f
ebrietas	f
ebulum	n
ebur	???
eburones_n	m
eburouices_n	m
ebusus_n	f
ecbatana_n	n
ecbolima_n	n
ecclesia	f
ecdicus	m
echeneis	f
echidna	f
echinus	m
ecloga	f
edessa_n	f
edictio	f
edictum	n
edita	n
editio	f
editum	n
edonis_n	f
edoni_n	*
educatio	m
educator	f
eductio	f
eetion_n	m
effatum	n
effectus_1	*
efficiens_1	n
effigia	f
effigies	f
efflagitatio	f
efflagitatus	m
effluuium	n
effractarius	*
effrenatio	f
effugium	n
effusio	f
egeria_n	f
egerius_n	m
egestas	f
egestas_n	f
egestio	f
egnatia_n	???
egnatius_n	*
egnatuleius_n	???
egregium	neutre
egressus	m
eiectamentum	n
eiectio	f
eiectus	m
eiulatio	f
eiulatus	m
eiuratio	f
elaptonius_n	4
elatea_n	f
elatio	f
elauer_n	n
eleazarus_n	???
elecebra	f
electa	f
electio	f
electra_n	f
electrum	n
electrus_n	*
electus_1	m
elegantia	f
elegeia_n	f
elegi	m
elegia_n	f
elegidion	n
elei_n	???
eleleides_n	f
elementa	n
elementum	n
elenchus	m
elephantus	m
elephas	
elesioduli_n	3
eleusin_n	f
eleusium_n	n
eleuteti_n	*
elias_n	m
elicius_n	???
elisio	f
elissa_n	f
elis_n	f
elius_n	*
elocutio	f
elogium	n
eloquentia	f
eloquium	n
elorini_n	*
elorus_n	m
elpenor_n	m
eluacrum	n
elusates_n	m
eluuies	f
eluuio	f
elymaei_n	*
elysii_n	???
elysium_n	n
emacitas	f
emancipatio	f
emathia_n	f
emblema	f
emblema	f
embolium	n
embolum	n
emendatio	f
emendator	m
emeritenses_n	???
eminatio	f
emissarius	*
emissus	m
emolumentum	n
empedocles_n	m
emplastrum	n
emporium	n
emptio	f
emptor	m
enarratio	f
enceladus_n	m
encolpius_n	*
endromis	f
enguini_n	*
enipeus_n	m
enna_n	f
ennia_n	2
ennius_n	*
ennosigaeus_n	m
enormitas	f
ensis	m
entellini_n	???
entellus_n	m
enumeratio	f
enuntiatum	n
eoi_n	???
eous_n	m
epaminondas_n	m
epaphroditus_n	m
epasnactus_n	m
epeus_n	m
ephebus	m
ephemeridae	???
ephemeris	f
ephesii_n	???
ephesus_n	f
ephippium	n
ephorus	m
ephorus_n	m
epibata	m
epicharis_n	f
epicharnus_n	4
epicrates_n	m
epicurei_n	*
epicurus_n	m
epidamnus_n	f
epidaphnes_n	f
epidaurum_n	???
epidaurus_n	f
epidicus_n	???
epidipnis	f
epidromus	m
epigoni_n	m
epigonus_n	m
epigramma	n
epigrus	m
epilogus	m
epimachus_n	m
epirenses_n	3
epirhedium	n
epirus_n	f
epistates	m
epistola	???
epistola_n	???
epistolium	n
epistomium	n
epityrum	n
epona_n	f
eporedia_n	f
eporedorix_n	m
eppia_n	???
eppius_n	*
epponina_n	f
eprius_n	*
epulae	f
epulatio	f
epulo	m
epulo_1	m
epulo_n	m
epulum	n
epytus_n	m
equa	f
eques	m
equestria	???
equile	n
equirria_n	2
equitatus_1	*
equuleus	m
equus	m
eranus	m
erasinus_n	*
eratosthenes_n	m
erebus_n	???
erechtheus_n	*
ereptio	f
ereptor	m
eretrici_n	???
eretum_n	n
ergasilus_n	???
ergastulum	n
ergenna_n	m
erices_n	3
erichthonius_n	*
ericius	*
ericthonius_n	4
eridanus_n	m
erigyius_n	m
erillus_n	???
erinnyes_n	???
erinnys_n	???
eriphyla_n	f
erneum	n
erogatio	f
eros_n	m
erratum	n
error	m
error_n	m
erro_1	
ersilaus_n	4
eruca	f
erucius_n	m
eruditi	masculin
eruditio	f
eruilia	f
eruptio	f
eruum	???
erycina_n	???
erycus_n	m
erylus_n	m
erymanthus_n	m
erythea_n	f
erythinus	m
erythrae_n	f
erythrus_n	???
eryx_n	m
esca	f
escensio	f
escensus	m
esquiliae_n	f
esseda	f
essedarius_1	m
essedum	n
essentia	f
essubii_n	3
esuritio	f
etesiae	m
etesius_n	*
ethymantus_n	m
etruria_n	f
etrusci_n	*
euagatio	f
euander_n	m
euan_n	m
euboea_n	f
eubulidas_n	m
eucaerus_n	m
euchadia_n	f
eudaemon_n	m
eudemus_n	m
eudoses_n	m
euectio	f
euentum	n
euentura	f
euentus	m
euenus_n	m
euergetae_n	m
euerriculum	n
euersio	f
euersor	m
euhenus_n	4
euhius	???
euhius_n	???
eumelus_n	m
eumenes_n	m
eumenides_n	f
eumolpidae_n	m
eumolpus_n	m
eunaeus_n	m
eunomia_n	f
eunones_n	m
eunuchus	m
euocati	???
euocatio	f
euocator	m
euodus_n	???
eupholius_n	4
euphranor_n	m
euphrates_n	m
euphrosyne_n	???
eupolemus_n	m
eupolis_n	m
euripides_n	m
euripus	m
euripus_n	m
europa_n	f
europe_n	???
eurotas_n	m
eurus	m
eurus_n	m
euryalus_n	m
eurybates_n	m
eurylochus_n	m
eurymachus_n	m
eurypylus_n	m
eurystheus_n	*
eurythmus_n	m
eurytus_n	m
euthynicus_n	4
eutrapelus_n	m
eutychus_n	???
euxinus_n	*
exactio	f
exactor	m
exaerambus_n	4
examen	n
exanimatio	f
excellentia	f
excelsitas	f
excelsum	n
exceptio	f
exceptiuncula	f
excessus	m
excetra	f
excidio	f
excidium_1	n
excisio	f
exclamatio	f
excrementum	n
excubiae	f
excubitor	m
excubitus	m
excursio	f
excursor	m
excursus	m
excusatio	f
execestus_n	m
exedra	f
exemplar	n
exemplares	???
exemplum	n
exercitatio	f
exercitio	f
exercitium	n
exercitus_1	m
exesor	m
exhortatio	f
exiguitas	f
exiguum_1	n
exilitas	f
existimatio	f
existimator	m
exitium	n
exitus	m
exodium	n
exoleti	masculin
exordium	n
exorsa	n
exorsus	m
exortus	m
exostra	f
exoticum	n
expeditio	f
expeditum	n
expensum	n
experientia	f
experimentum	n
expiatio	f
expilatio	f
explanatio	f
explementum	n
explicatio	f
exploratio	f
explorator	m
exportatio	f
expostulatio	f
exprobratio	f
exprobrator	m
exprobratrix	f
expugnatio	f
expugnator	m
expulsio	f
expulsor	m
expurgatio	f
exsecratio	f
exsectio	f
exsecutio	f
exsequiae	f
exsilium	n
exsolutio	f
exspectatio	f
exspectatum	n
exstimulator	m
exstinctor	m
exstructio	f
exsul	???
exsultatio	f
exta	n
externi	m
externum	neutre
extersus	m
extitius_n	4
extrema	???
extremitas	f
extremum	???
exulceratio	f
exundatio	f
exuuiae	f
exuuium	n
faba	f
fabalia	f
fabaris_n	m
fabatus_n	m
faba_n	f
fabella	f
faber_1	m
fabianus_n	*
fabius_n	*
fabrateria_n	f
fabraterni_n	*
fabrica	f
fabricator	m
fabricius_n	*
fabulator	m
fabula_1	f
fabulla_n	???
fabullus_n	*
fabulus	m
facetiae	f
facies	f
facilitas	f
facinus	n
factio	f
factor	m
factum	n
factus_1	m
facula	m
facultas	f
facundia	f
fadia_n	f
fadius_n	*
fadus_n	m
faecula	f
faenius_n	*
faenus	n
faesidius_n	m
faesulae_n	f
faex	f
fagus	m
fala	f
falanius_n	???
falarica	f
falcarius	*
falcidius_n	*
falcula	m
falcula_n	m
falernum_n	???
falisci_n	m
fallacia	f
falsarius	*
falsimonia	f
falsum	n
falx	f
fama	f
fama_n	f
fames	f
fames_n	f
familia	m
familiaris_1	m
familiaritas	f
famul	
famula	f
famulatus	m
famulus_1	m
fannia_n	2
fannius_n	*
fanum	n
fanum_n	n
far	n
farina	f
farrago	f
fartor	m
fas	n
fascia	f
fasciculus	m
fascina	f
fascinum	???
fasciola	f
fascis	m
fasti	m
fastidium	n
fastigium	n
fastus_1	m
fastus_2	m
fatidicus_1	*
fatigatio	f
fatua	f
fatum	n
fatum_n	n
fatus	m
fatuus_1	m
fauentinus_n	*
fauilla	f
fauni_n	m
faunus	*
faunus_n	*
fauonius	*
fauonius_n	*
fauor	m
fausta_n	???
faustitas_n	f
faustulus_n	m
faustus_n	*
fautor	m
fautrix	f
fauus	m
faux	f
fax	f
febricula	f
febris	f
febris_n	f
februa	n
februarius_n	m
februum	???
fecunditas	f
fel	n
feles	f
felicio_n	???
felicitas	f
felicitas_n	f
felix_n	m
femella	f
femen	???
femina	f
femur	n
feneratio	???
fenerator	???
fenestella_n	2
fenestra	f
feniculum	n
fenilia	n
feniseca	m
fenni_n	*
fenum	???
fenus	???
fera	f
feralia	???
feralia_n	???
ferculum	n
ferentani_n	*
ferentarius	m
ferentinum_n	n
ferentium_n	n
ferentum_n	n
feretrum	n
feriae	f
fericulus	masculin
ferina	f
feritas	f
fermentum	n
ferocia	f
ferocitas	f
feronia_n	f
ferox_n	m
ferramentum	n
ferraria_1	f
ferrarius_1	*
ferrea	f
ferrugo	f
ferrum	n
ferrumen	n
fertilitas	f
fertum	n
ferula	f
feruor	m
ferus_1	*
fescenninus_1	*
festinatio	f
festiuitas	f
festuca	f
festucula	f
festum	n
festus_n	*
fetialis_1	m
fetura	f
fetus_1	m
fiber	m
fibra	f
fibula	f
fibulus_n	m
ficedula	f
ficedulenses_n	???
fictile	???
fictor	m
fictum_1	n
ficus_1	m
ficus_1	m
ficus_1	m
fidelia	f
fidelitas	f
fidenae_n	f
fidena_n	f
fides_1	f
fides_2	f
fides_n	f
fidicen	m
fidicen_n	m
fidicina	f
fidicula	f
fidiculanius_n	masculin
fidius_n	*
fiducia	f
fidulius_n	4
fidus_n	*
figulus	m
figulus_n	m
figura	f
filia	f
filicula	f
filiola	f
filiolus	m
filius	*
filix	f
filum	n
fimbria	m
fimbriae	f
fimbria_n	m
fimus	???
finis	f
finitimi	m
finitio	f
finitor	m
firmamen	n
firmamentum	n
firmani_n	???
firmator	m
firmidius_n	*
firminus_n	*
firmitas	f
firmitudo	f
firmius_n	???
firmus_n	m
fiscella	f
fiscellus_n	m
fiscina	f
fiscus	m
fissum	n
fistuca	f
fistula	f
fitilla	f
flabellum	n
flabrum	n
flaccilla_n	???
flaccus_n	m
flagellum	n
flagitatio	f
flagitator	m
flagitium	n
flagrantia	f
flagrum	n
flamen_1	m
flamen_2	m
flaminia_n	f
flaminica	f
flamininus_n	m
flaminium	???
flaminius_n	*
flamma	m
flammarius	m
flamma_n	m
flammeolum	n
flammeum	n
flatura	f
flatus	m
flauianus_n	*
flauius_n	*
flauus_n	m
flemina	n
fletus	m
fleuum_n	n
flexio	f
flexura	f
flexus	m
flictus	m
floccus	m
floralia_n	n
flora_n	f
florentini_n	3
florus_n	m
flos	m
flosculus	m
fluctuatio	f
fluctus	m
fluentum	n
flumen	n
fluuius	m
focale	n
foculus	m
focus	m
foeditas	f
foedus_1	m
foetor	m
foliatum	n
folia_n	f
folium	n
folliculus	m
follis	m
follitus	*
fomentum	n
fomes	m
fons	m
fonteia_n	???
fonteius_n	*
fonticulus	m
foramen	n
forceps	m
forda	f
forensia	???
forica	f
foris_1	
forma	f
formamentum	n
formatio	f
formator	m
formatura	f
formiae_n	f
formianum_n	???
formica	2
formido_1	f
formido_n	f
formositas	f
formula	f
fornacalia_n	n
fornacula	f
fornax	f
fornax_n	f
fornicatio	f
fornix	m
foroiulienses_n	3
fors_1	f
fors_n	f
fortax	m
fortitudo	f
fortuita	2
fortuna	f
fortunata_n	n
fortunatus_n	*
fortuna_n	f
foruli	m
foruli_n	m
forum_1	n
forum_2	n
forum_n	n
forus	m
fosi_n	*
fossa	f
fossio	f
fossor	m
fossula	f
fouea	f
fraces	f
fractura	f
fraga	n
fragilitas	f
fragmen	n
fragmentum	n
fragor	m
fragum	n
framea	f
frater	m
fraterculus	m
fraternitas	f
fratricida	m
fraudatio	f
fraudator	m
fraus	f
fraxinus	f
fregellanus_n	masculin
fremitus	m
fremor	m
frenator	m
freni	3
frentrani_n	3
frenum	???
frequentia	f
fretum	n
fretus_1	m
frigida	f
frigidum	n
frigus	n
frisii_n	*
fritillus	m
friuola	f
frondator	m
frons_1	f
frons_2	f
frontinus_n	*
fronto_n	m
fructus	m
frugalitas	f
frugi_n	2
frugi_n	2
frumentarius_1	*
frumentatio	f
frumentator	m
frumentum	n
frusino_n	m
frustramen	n
frustratio	f
frustum	n
frutex	m
fruticetum	n
frux	f
fucinus_n	*
fucus_1	m
fucus_2	m
fuficius_n	4
fufidius_n	???
fufius_n	*
fuga	f
fuga_n	f
fugela	f
fugitiuus_1	m
fulcimen	n
fulcinius_n	*
fulcipedia	f
fulcrum	n
fulginius_n	m
fulgor	m
fulgur	n
fulgurator	m
fulica	f
fuligo	f
fullo	m
fullonia	f
fulmen	n
fulmenta	f
fultura	f
fuluia_n	???
fuluius_n	*
fuluus_n	m
fumus	m
funale	n
functio	f
functus	masculin
funda	f
fundamen	n
fundamentum	n
fundanius_n	*
fundanus_n	*
fundator_1	m
funditor	m
fundi_n	m
fundus	m
fungus	m
funiculus	m
funis	m
funisulanus_n	4
funus	n
funus_n	n
fur	2
furca	f
furcifer	m
furcifera	f
furcilla	f
furfanius_n	*
furfur	m
furia	f
furia_n	f
furius_n	*
furnius_n	*
furnus	m
furor_1	m
furor_n	m
furtum	n
furunculus_1	m
fuscina	f
fuscinus_n	???
fuscus_n	*
fustis	m
fustuarium	n
fusus_1	m
futuri	masculin
futurum	n
fututio	f
gabali_n	*
gabba_n	f
gabii_n	m
gabiniani_n	???
gabinianus_n	*
gabinius_n	*
gabolus_n	m
gades_n	f
gaditani_n	???
gaesum	n
gaetulicus_n	*
gaetuli_n	*
gaia_n	f
gaius_n	*
galaesus_n	???
galatae_n	m
galatea_n	f
galatia_n	f
galba_n	m
galbeus	???
galbinum	n
galea	f
galerianus_n	*
galeria_n	f
galerius_n	*
galerus	m
galesus_n	m
galilaei_n	*
galla	f
galla_n	f
gallia_n	f
gallina	m
gallina_n	m
gallio_n	m
gallitta_n	f
gallius_n	*
galli_n	*
gallograecia_n	f
gallograeci_n	*
gallonius_n	*
gallus	m
gallus_n	m
galus_n	4
gambriuii_n	*
ganea	m
ganeo	m
ganeum	n
gangaba	m
gangaridae_n	m
gangarides_n	m
ganges_n	m
gannascus_n	m
gannitus	m
ganymedes_n	m
garamantes_n	2
garganus_n	m
gargara_n	n
gargilius_n	*
gargonius_n	*
garrulitas	f
garum	n
garumna_n	2
garumni_n	*
garutianus_n	4
gastrum	n
gates_n	m
gauda_n	m
gaudimonium	n
gaudium	n
gaudium_n	n
gauianus_n	masculin
gauilla_n	???
gauius_n	*
gaurus_n	*
gausapa	f
gausapa	f
gausapum	n
gausapum	n
gaza	f
gazaba_n	???
gaza_n	f
geidumni_n	*
gela_n	f
gelduba_n	f
gelenses_n	???
gelicidium	n
gellius_n	*
geloni_n	*
gelonus_n	masculin
gelum	n
gelus	m
gemellinus_n	4
gemelli_n	*
gemellus_1	*
gemini	m
geminius_n	???
gemini_n	m
geminus_n	*
gemitus	m
gemma	f
gemoniae_n	???
gena	f
genaua_n	f
genauni_n	*
gener	m
generator	m
genesis	f
genetrix	f
genetrix_n	f
genista	f
genitalia	n
genitor	m
genitor_n	m
genius	m
genius_n	m
gens	f
gentilis_1	m
gentilitas	f
genu	n
genusus_n	m
genus_1	n
genus_2	n
geometres	???
geometria	f
gerellanus_n	*
gergouia_n	f
germana	f
germania_n	f
germanicus_n	*
germanitas	f
germani_n	*
germanus_1	*
germen	n
gerrae	f
gerulifigulus	*
gerulus_1	*
geryones_n	3
geryones_n	3
geryon_n	???
geryon_n	???
gessius_n	*
gesta	f
gestamen	n
gestatio	f
gestator	m
gestus	m
getae_n	m
geta_n	m
gibbus	*
gigas	m
gigas_n	m
gigeria	n
gillo_n	m
gingiliphus	m
gingiua	f
glaber_1	m
glabrio_n	m
glacies	f
gladiator	m
gladiatura	f
gladius	*
glandium	n
glans	f
glaphyrus_n	*
glarea	f
glaucia_n	m
glaucippus_n	m
glaucus_1	*
glaucus_n	*
gleba	f
glebula	m
glesum	???
glis	*
glitius_n	*
globulus	m
globulus_n	m
globus	m
glomeramen	n
glomus	n
gloria	f
gloria_n	f
gluten	n
glutus_1	*
glycera_n	f
glycon_n	???
gnaeus_n	*
gnatia_n	???
gnosia_n	???
gnosis_n	f
gobannitio_n	m
gobio	m
gobius	*
golgi_n	m
gomphenses_n	???
gomphi_n	m
gonoessa_n	2
gordium_n	n
gordius_n	*
gordyaei_n	*
gorgias_n	m
gorgobina_n	f
gorgo_n	f
gorneae_n	f
gortuae_n	m
gotarzes_n	3
gotones_n	m
grabatus	???
gracchus_n	m
gracilis_n	m
gracilitas	f
graculus	m
gradiuus_n	m
gradus	m
graecia_n	f
graecina_n	2
graecinus_n	*
graeci_n	*
graeculio_n	m
graeculi_n	???
graeculus_n	*
graii_n	*
graioceli_n	*
graiugena_n	2
grai_n	3
grama	f
gramen	n
grammatica_2	f
grammaticus_1	m
granarium	n
granatus	m
granditas	f
grando	f
granea	m
granicus_n	m
granius_n	*
granum	n
graphium	n
graptus_n	*
grassator	m
grates	f
gratia	f
gratianus_n	???
gratia_n	f
gratidianus_n	masculin
gratidius_n	???
gratificatio	f
gratilla_n	f
grattius_n	???
gratulatio	f
gratus_n	*
grauastellus	masculin
grauedo	f
grauiscae_n	f
grauitas	f
graupius_n	4
gregales	???
gremium	n
gressus	m
grex	m
grinnes_n	f
grosphus_n	m
grossus	m
grudii_n	*
grumentum_n	n
grumus	m
grus	
gryllus_n	m
gryps	m
grypus_n	*
gubernaculum	n
gubernatio	f
gubernator	m
gula	f
gulusa_n	m
gummi	???
gurges	m
gurges_n	m
gurgulio	m
gurgustium	n
gustatio	f
gustatorium	n
gustatus	m
gustus	m
gutta	m
gutta_n	m
guttula	f
guttur	???
guttus	???
gyara_n	???
gyarus_n	f
gyas_n	m
gyges_n	m
gylippus_n	m
gymnasiarchus	m
gymnasium	n
gynaeceum	n
gypsum	n
gyrus	m
gytheum_n	n
habena	f
habinnas_n	m
habitans	n
habitatio	f
habitator	m
habitus_1	m
habitus_n	m
habonius_n	m
hadriacum_n	neutre
hadrianus_n	*
hadriaticum_n	???
hadria_n	f
hadrumetini_n	???
hadrumetum_n	n
haedilia	f
haedillus	m
haedui_n	*
haedulus	m
haedus	m
haedus_n	m
haemonia_n	f
haemonis_n	f
haemon_n	m
haemus_n	m
haesitantia	f
haesitatio	f
haesitator	m
hagna_n	f
halaesa_n	f
halaesini_n	masculin
halaesus_n	m
halicarnassii_n	???
halicarnassus_n	m
halicyenses_n	???
halitus	m
halius_n	m
halophanta	m
halotus_n	m
halus_n	m
halys_n	m
hama	f
hamadryades_n	f
hamilcar_n	m
hamillus_n	*
hammonii_n	???
hammon_n	m
hamus	m
hannibal_n	m
hara	f
harii_n	*
hariolus	m
harmerides_n	f
harmodius_n	*
harmonia	f
harmonia_n	f
harpago_1	
harpagus_n	m
harpalus_n	m
harpalycus_n	m
harpocras_n	m
harpocrates_n	m
harpyia_n	???
harudes_n	m
haruspex	m
haruspicium	n
hasdrubal_n	m
hasta	f
hastatus_1	*
hasta_n	f
hastile	n
haterius_n	*
haustrum	n
haustus	m
hebetatio	f
hebrus_n	m
hecataeus_n	m
hecate_n	f
hector_n	m
hecuba_n	f
hedera	f
hedia	2
hedymeles_n	m
hegelochus_n	m
hegesimachus_n	4
heius_n	*
helena_n	f
helene_n	???
helenor_n	m
helenus_n	m
heliades_n	m
heliconiades_n	f
helicon_n	???
heliocaminus	m
heliodorus_n	*
heliopolis_n	f
helisii_n	m
helius_n	*
hellanicus_n	m
hellas_n	f
helleborum	n
helleborus	m
hellespontus_n	m
hellusii_n	*
helops	m
heluatio	f
helueconae_n	???
heluetii_n	3
heluidius_n	*
heluii_n	*
heluius_n	*
heluo	m
helymus_n	4
hemicyclium	n
hemina	m
hendecasyllabus	m
heneti_n	*
heniochi_n	*
henna_n	f
hennenses_n	???
hepatia	n
hephaestion_n	???
hera	f
heraclea_n	f
heracleotae_n	m
heracleus_n	*
heraclides_n	m
heraclienses_n	???
heraclitus_n	m
heraclius_n	*
herba	f
herbesus_n	???
herbita_n	f
herbitenses_n	???
herbula	f
herculanense_n	neutre
herculeius_n	4
hercules_n	m
hercules_n	m
heredipeta	m
hereditas	f
herennius_n	*
heres	m
herifuga	m
herius_n	*
hermagoras_n	???
hermarchus_n	m
hermeros_n	m
hermes_n	m
hermes_n	m
herminius_n	*
herminones_n	m
hermione_n	f
hermippus_n	m
hermobius_n	m
hermogenes_n	m
hermolaus_n	m
hermunduri_n	*
hermus_n	m
hernici_n	*
herodes_n	m
herodotus_n	m
herodus_n	4
heroine	*
heros	m
heroum	n
herus	m
hesiodus_n	m
hesiona_n	f
hesperia_n	f
hesperides_n	f
hesperii_n	masculin
hesperus_n	m
hesus_n	m
hetaeria	f
hiatus	m
hiberia_n	f
hiberina_n	f
hiberi_n	3
hiberna	n
hibernaculum	n
hibernia_n	f
hibernum	n
hiberus_n	*
hibiscum	???
hiempsal_n	m
hiems	f
hiems_n	f
hieras_n	m
hierocaesaria_n	???
hieronymus_n	m
hieron_n	m
hierosolymus_n	???
hilaira_n	f
hilaritas	f
hilarus_n	*
hilla	f
hilum	n
himella_n	f
himera_n	f
himera_n	f
hinnitus	m
hinnuleus	m
hipparchus_n	m
hippias_n	m
hippocoon_n	m
hippocrates_n	m
hippodamia_n	f
hippodromos	???
hippodromus	???
hippolyta_n	2
hippolytus_n	m
hippomanes	n
hipponous_n	m
hippon_n	m
hippoperae	f
hippotoxotae	m
hippurus	m
hira	f
hircus	m
hirnea	f
hirpinus_n	masculin
hirrus_n	m
hirtius_n	*
hirtuleius_n	4
hirudo	f
hirundo	f
hispalenses_n	???
hispalis_n	f
hispania_n	f
hispani_n	???
hispanus_n	*
hispellates_n	???
hispo_n	m
hispulla_n	f
hister_n	m
historia	f
historia_n	f
historicus_1	m
histria_n	f
histrio	m
histrionia	f
homerista_n	???
homerus_n	m
homicida	m
homicidium	n
homo	m
homonadenses_n	???
homullus	m
homullus_n	m
homuncio	m
homunculus	m
honestamentum	n
honestas	f
honesti	masculin
honestum	n
honestus	*
honor	m
honoratus_n	???
honor_n	m
hora	f
horaeum	???
horatius_n	*
hora_n	f
hordeia	f
hordeonius_n	*
hordeum	n
horitae_n	???
hormus_n	m
horologium	n
horoscopus	???
horreum	n
horror	m
horror_n	m
hortalus_n	m
hortamen	n
hortamentum	n
hortatio	m
hortator	m
hortatus	*
hortensius_n	*
hortulus	m
hortus	m
hospes	2
hospita	f
hospitalitas	f
hospitium	n
hostes	???
hostia	f
hosticum	n
hostile	???
hostilia_n	f
hostilius_n	*
hostimentum	n
hostis	m
hostus	m
humana	2
humani	???
humanitas	f
humanum	???
humerus	m
humidum	neutre
humilitas	f
humor	
humus	???
hyacinthus	m
hyacintus_n	4
hyades_n	f
hyalus	m
hyas_n	m
hybla_n	f
hyblenses_n	???
hybrida	m
hydaepa_n	2
hydaspes_n	m
hydra	f
hydraules	???
hydra_n	f
hydria	f
hydrochoeus_n	4
hydrops	m
hydrus	m
hylaeus_n	*
hylas_n	m
hylax_n	m
hyllus_n	m
hymen	m
hymenaeus	4
hymenaeus_n	4
hymen_n	m
hymettus_n	*
hypaepeni_n	*
hypanis_n	m
hyperborei_n	*
hyperides_n	m
hyperion_n	m
hypermestra_n	f
hypogeum	n
hypsaea_n	2
hypsaeus_n	???
hypsides_n	m
hypsipyle_n	f
hyrcania_n	f
hyrcani_n	*
hyrtacides_n	m
hyrtacus_n	m
hystaspes_n	m
iacchus_n	m
iacetani_n	*
iactantia	f
iactatio	f
iactatus	*
iactura	f
iactus	m
iaculatio	f
iaculator	m
iaculatrix	f
iaculum	n
iaculus_1	*
iadestini_n	3
iaera_n	f
ialysus_n	m
iambus	m
ianiculum_n	n
ianitor	m
ianitor_n	m
ianitrix	f
ianua	f
ianuarius_n	*
ianus	m
ianus_n	m
iapetus_n	m
iapydes_n	2
iapydia_n	f
iapyx_n	m
iarbas_n	m
iarba_n	m
iarbitas_n	???
iasius_n	*
iaspis	m
iatralipta	m
iatraliptes	m
iauolenus_n	???
iazyges_n	2
iberia_n	f
iberi_n	*
iberus_n	*
ibis_n	m
ibycus_n	m
icaria_n	f
icarium_n	neutre
icarius_n	*
icarus_n	m
iccius_n	*
icelus_n	m
iceni_n	*
iconismus	m
ictus	m
idaei_n	???
idaeus_n	*
idalia_n	f
idalium_n	n
idarnes_n	3
idas_n	m
ida_n	f
idea	f
ide_n	f
idiota	m
idistauisus_n	???
idmon_n	m
idomeneus_n	*
idrus_n	m
idus	f
idyia_n	f
idyllium	n
iecur	???
ieiunitas	f
ieiunium	n
ientaculum	n
ierusalem_n	f
ierusalem_n	f
ietini_n	???
igilium_n	n
ignauia	f
ignauus_1	*
igniculus	m
ignis	m
ignobilitas	f
ignominia	f
ignorantia	f
ignoratio	f
iguini_n	???
iguuinates_n	2
ilerda_n	f
ilex	f
ilia	f
ilia	f
iliades_o	f
iliades_o	f
ilias_n	f
ilia_n	f
iliberris_n	f
ilienses_n	2
ilii_n	3
iliona_n	f
ilioneus_n	m
ilipa_n	f
ilissus_n	???
ilithyia_n	f
ilium	n
ilium_n	n
illecebra	f
illectus_1	*
illex_1	*
illiberalitas	f
illicitator	m
illurgauonenses_n	???
illuuies	f
illyria_n	f
illyricum_n	n
illyrii_n	*
ilua_n	f
ilus_n	m
imacharenses_n	???
imaginatio	f
imago	f
imbecilli	masculin
imbecillitas	f
imber	m
imbrasus_n	m
imbrex	m
imbrus_n	m
imitamen	n
imitamentum	n
imitatio	f
imitator	m
imitatrix	f
immanitas	f
immaturitas	f
immensum_1	n
immeritum	n
immissio	f
immoderatio	f
immodestia	f
immolatio	f
immortales_n	m
immortalitas	f
immunitas	f
immutatio	f
impatientia	f
impedimentum	n
impeditum	n
impendium	n
impensa	f
imperator	m
imperator_n	m
imperatrix	f
imperatum	n
imperitia	f
imperium	n
impes	m
impetus	m
impietas	f
impietas_n	f
implicatio	f
imploratio	f
impluuium	n
importunitas	f
impotentia	f
impraesentiarum	
imprecatio	f
impressio	f
improbatio	f
improbitas	f
improuisum	???
imprudentia	f
impudentia	f
impudicitia	f
impulsor	m
impulsus	m
impunitas	f
impuritas	f
imputator	m
imum	???
inachia_n	???
inachides_n	m
inachis_n	f
inachus_n	m
inaequalitas	f
inambulatio	f
inane	n
inaniae	f
inanitas	f
incendiarius_1	*
incendium	n
incensio	f
inceptum	n
inceptus_1	m
incerniculum	n
incertum	n
incessus	m
incestum	n
incestus_1	m
incidentia	n
incile	n
incitamentum	n
incitatio	f
inclementia	f
inclinatio	f
inclusio	f
incola	2
incolumitas	f
incommoditas	f
incommodum	n
inconstantia	f
incontinentia	f
incrementum	n
incubo_n	m
incultus_1	m
incunabula	n
incuria	f
incursio	f
incursus	m
incus	m
incussus	m
indagatio	f
indago_1	f
index	m
india_n	f
indicium	n
indictio	f
indigena	f
indigens_1	???
indigentia	f
indiges_n	m
indigetes_n	m
indignatio	f
indignatiuncula	f
indignitas	f
indiligentia	f
indi_n	*
indolentia	f
indoles	m
inductor	m
inductus	m
inducula	f
indulgentia	f
indusiarius	m
industria	f
indus_n	*
indutiae	f
indutiomarus_n	???
indutus	m
inedia	f
inenses_n	2
ineptia	f
ineptiae	???
inertia	f
infacetiae	f
infamia	f
infans_1	2
infantia	f
infector	m
infecunditas	f
infelicitas	f
inferi	m
inferiae	f
inferiora	neutre
inferiores	???
inferi_n	m
inferna	n
inferni	*
infidelitas	f
infimum	???
infirmatio	f
infirmitas	f
infitiatio	f
infitiator	m
inflammatio	f
infortunium	n
infrequentia	f
infula	f
infundibulum	n
ingaeuones_n	m
ingenium	n
ingenuitas	f
ingluuies	f
ingratia	f
ingressio	f
ingressus	m
inguen	n
inguiomerus_n	m
inhumanitas	f
iniectio	f
iniectus	m
inimicitia	f
inimicus_1	*
iniquitas	f
iniquus_1	m
initiamenta	???
initium	n
initus	m
iniuria	f
iniussus_1	*
iniustitia	f
iniustum	???
innocentia	f
innupta	f
inopia	f
inopinatum	???
ino_n	f
inquilinus	m
inquisitio	f
inquisitor	m
insania	f
insatietas	f
inscientia	f
inscitia	f
inscriptio	f
inscriptum	n
insectatio	f
insidiae	f
insidiae_n	f
insidiator	m
insigne	n
insilia	n
insimulatio	f
insipientia	f
insitio	f
insitor	m
insolentia	f
insomnium	n
inspectatio	f
inspectio	f
inspector	m
inspectus	m
instantia	f
instar	
instauratio	f
insteius_n	*
instigator	m
instigatrix	f
instimulator	m
instinctor	m
instinctus_1	m
instita	f
institor	m
institutio	f
institutum	n
instragulum	n
instratum	n
instructio	f
instructor	m
instrumentum	n
insubres_n	m
insula	f
insularius	m
insula_n	f
insulsitas	f
intactus_1	m
integritas	f
integumentum	n
intellectus	m
intelligentia	f
intemperantia	f
intemperiae	f
intemperies	f
intentatio	f
intentio	f
intentus_1	m
interamnates_n	m
interamna_n	f
interamnium_n	n
intercapedo	f
interceptio	f
interceptor	m
intercessio	f
intercessor	m
intercolumnium	n
intercursus	m
interdictio	f
interdictum	n
interemptor	m
interfatio	f
interfector	m
interfectrix	f
interiectus	m
interiora	n
interitio	f
interitus	m
interlunium	n
intermissio	f
internecio	f
internuntia	f
internuntius	*
interpellatio	f
interpellator	m
interpres	m
interpretamentum	n
interpretatio	f
interpunctio	f
interrex	m
interrogatio	f
interrogatiuncula	f
intertrigo	f
intertrimentum	n
interuallum	n
interuentus	m
intestina	f
intestinum	n
intimus	*
intolerantia	f
introductio	f
introitus	m
intubum	n
inuectio	f
inuentio	f
inuentor	m
inuentrix	f
inuentum	n
inuestigatio	f
inuestigator	m
inueteratum	n
inuia	f
inuidia	f
inuidus_1	*
inuitamentum	n
inuitatio	f
inula	f
inundatio	f
inuolucre	n
inuolucrum	n
inutilitas	f
inuus_n	m
iocasta_n	f
iocatio	f
iocus	m
iocus_n	m
iolaus_n	m
iolla_n	m
iones_n	m
ionia_n	f
ionium_n	???
io_n	f
iphianassa_n	f
iphiclus_n	m
iphigenia_n	f
iphitus_n	m
ipsithilla_n	f
ira	f
iracundia	f
ira_n	f
iris	f
iris_n	f
irpex	m
irreuerentia	f
irridiculum	n
irrigatio	f
irrisio	f
irrisor	m
irrisus	m
irritamentum	n
irritatio	f
irritator	m
irritum	n
irrogatio	f
irrumatio	f
irrumator	m
irruptio	f
irus_n	m
isaeus_n	m
isauricus_n	*
iselasticum	n
iselasticus_1	*
isidorus_n	m
isis_n	f
ismara_n	???
ismarus_n	m
ismenus_n	m
isocrates_n	m
issa_n	f
issos_n	m
istaeuones_n	m
isthmia_n	n
isthmus_n	m
italia_n	f
italica_n	???
italicenses_n	???
italicus_n	*
itali_n	*
italus_n	m
iter	n
iteratio	f
ithaca_n	f
ithacus_n	*
itius_n	m
itonus_n	m
ituraei_n	*
iturius_n	*
itus	m
itylus_n	m
itys_n	m
iuba	m
iubar	n
iuba_n	m
iucunditas	f
iudaea_n	f
iudaei_n	m
iuda_n	m
iudex	m
iudicatum	n
iudicatus_1	*
iudicium	n
iugatio	f
iugerum	???
iugerum	???
iugulae_n	2
iugulatio	f
iugulum	n
iugulus	m
iugum	n
iugumentum	n
iugurtha_n	m
iuliani_n	3
iulianus_n	*
iulia_n	f
iuliopolitani_n	*
iulis	f
iulius_n	*
iullus_n	???
iulus_n	m
iumentum	n
iunctura	f
iuncus	m
iuncus_n	m
iunia_n	???
iunior	m
iunior_n	m
iuniperus	*
iunius_n	*
iunix	f
iunonicola_n	???
iuno_n	f
iuppiter_n	m
iurator	m
iura_n	m
iurgium	n
iuridicus_1	m
iurisconsultus	???
iurisdictio	???
iusculum	n
iusiurandum	???
iussum	n
iussus	m
iusta	f
iustitia	f
iustitia_n	f
iustitium	n
iustum	n
iustus_n	*
ius_1	n
ius_2	n
iuturna_n	f
iuuenalia_n	n
iuuenalis_n	2
iuuenca	f
iuuencus_1	m
iuuenis_1	2
iuuenta	f
iuuentas	f
iuuentas_n	f
iuuentius_n	???
iuuentus	f
ixion_n	???
kalendae	f
kalendarium	n
labdacus_n	m
labeates_n	m
labecula	f
labellum_1	n
labellum_2	n
labeo_n	m
laberius_n	*
labes	f
labia	f
labici_n	m
labienus_n	*
labor_1	m
labor_n	m
labrum_1	n
labrum_2	n
labrusca	f
labyrinthus	m
lac	???
lacaena_n	f
lacedaemonii_n	3
lacedaemon_n	*
laceratio	f
lacerna	f
lacerta	m
lacerta_n	m
lacertus_1	m
lacertus_2	m
lacetania_n	f
lachesis_n	f
lacinia	f
lacones_n	m
lacon_n	???
laco_n	m
lacrima	f
lacrimula	f
lactes	f
lactuca	f
lacuna	f
lacunar	n
lacus	m
laecanius_n	m
laeca_n	2
laelia_n	???
laelius_n	*
laena	f
laenas_n	2
laenius_n	*
laertes_n	???
laestrygones_n	2
laetilius_n	4
laetitia	f
laetitia_n	f
laetus_1	*
laeua_1	f
laeua_2	f
laeuinus_n	*
laeuum_1	n
laganum	n
lagena	f
lagois	f
laguncula	f
lagus_n	m
lais_n	2
laius_n	m
lama	f
lamella	f
lamellula	f
lamenta	f
lamentatio	f
lamentum	n
lamia_n	m
lamina	f
lampadium_n	n
lampas	f
lampsaceni_n	???
lampsacus_n	f
lamus_n	m
lamyrus_n	*
lana	f
lanarius_1	m
lanarius_n	m
lancea	f
lancinatio	f
langobardi_n	*
langor	m
languor	m
laniatus	m
laniena	f
lanigera	f
laniger_1	*
lanio_1	m
lanista	m
lanitium	???
lanius	*
lanugo	f
lanuuini_n	???
lanuuium_n	n
lanx	f
laocoon_n	m
laodamia_n	f
laodicea_n	f
laodiceni_n	???
laodicia_n	f
laomedontiades_n	m
laomedon_n	m
lapathum	???
lapathus	m
lapicidinae	f
lapidarius_1	*
lapidatio	f
lapidator	m
lapillus	m
lapis	m
lapithae_n	m
lapitha_n	m
lappa	m
lappa_n	m
lappius_n	4
lapsus	m
laquear	???
laqueus	m
lara_n	f
larcius_n	*
lardum	n
larentalia_n	n
larentia_n	f
lares_n	m
larga_n	???
largitio	f
largitor_1	m
largus_n	*
laridum	n
larifuga	2
larinates_n	m
larina_n	2
larinum_n	n
larisaei_n	masculin
larisa_n	f
larius_n	m
laronia_n	???
lars	???
larua	f
larua_n	f
lar_n	m
lasanum	n
lasanus	m
lasciuia	f
laserpicium	n
lassitudo	f
latagus_n	m
latebra	f
later	m
lateramen	n
lateranus_n	*
laterculus	m
laterensis_n	2
latericium	n
latericulus	???
laterna	f
laternarius	m
latex	m
latiaris_n	2
latibulum	n
latifundium	n
latina_n	n
latinienses_n	3
latiniensis_n	???
latinius_n	*
latini_n	*
latinus_n	*
latio	m
latitudo	???
latium_n	n
latobrigi_n	???
latona_n	f
latonia_n	???
latonigena_n	2
lator	m
latous_n	*
latrator	m
latratus	m
latrina	f
latris_n	2
latrocinium	n
latro_1	m
latrunculus	m
latum_n	n
latura	f
latusculum	n
latus_1	*
lauabrum	???
laudatio	f
laudator	m
laudatrix	f
laudicenus	m
lauerna_n	f
lauinia_n	f
lauinium_n	n
laurea	2
laurentes_n	???
laurentinum_n	???
laureolus_n	m
laurus	m
laurus	m
laurus	m
laus	f
lausus_n	m
lautitia	f
lautumiae	f
laxamentum	n
laxitas	f
lea	f
leaena	f
leaena_n	f
leander_n	m
learchus_n	m
lebedus_n	f
lechaeum_n	n
lectica	f
lecticarius	*
lecticula	f
lecticulus	m
lectio	f
lector	m
lectulus	m
lectus_1	m
leda_n	f
legatio	f
legatum	n
legatus	*
legens	???
legerda_n	2
legio	f
legulus	m
legumen	n
lemannus_n	???
lembus	m
lemma	n
lemniades_n	???
lemonia_n	f
lemonum_n	???
lemouices_n	2
lemouii_n	*
lemures	m
lemuria_n	n
lena	f
lenaeus_n	*
lenimen	n
lenimentum	n
lenitas	f
lenitudo	f
lennius_n	4
lenocinium	n
leno_1	
lens_1	m
lens_2	m
lenticula_n	f
lentidius_n	4
lentinus_n	???
lentiscus	m
lentitudo	f
lento_n	
lentulus_n	*
lenunculus	m
leo	m
leonidas_n	m
leonida_n	2
leonnatus_n	m
leontini_n	m
leon_n	m
leoprepides_n	m
leo_n	m
lepidani_n	masculin
lepida_n	f
lepidus_n	*
lepontii_n	*
lepor	m
lepos	???
lepos_n	???
leptines_n	m
leptis_n	m
leptitani_n	???
lepus	n
lepusculus	m
lerna_n	f
lesbiades_n	???
lesbia_n	f
lesbides_n	???
lesbium_n	???
lesbius_n	*
lesbos_n	f
lethargicus	*
lethargus	*
letum	n
letum_n	n
leuaci_n	*
leuamen	n
leuamentum	n
leuator	m
leucadia_n	f
leucaspis_n	m
leucas_n	f
leucates_n	f
leucippis_n	f
leucippus_n	m
leuci_n	*
leucopetra_n	f
leucophryne_n	f
leucosyri_n	*
leucothea_n	f
leuctra_n	n
leuitas_1	???
leuitas_2	???
leuor	m
lex	f
lexouii_n	???
libamen	n
libamentum	n
libanus_n	m
libarius	m
libatio	f
libella	f
libellus	m
libentia_n	f
liberalia_n	???
liberalis_n	2
liberalitas	f
liberatio	f
liberator	m
libera_n	f
liberi	m
liberta	f
libertas	f
libertas_n	f
libertina	f
libertinus_1	*
libertus	*
liber_1	m
liber_n	m
libethrides_n	f
libido	f
libido_n	f
libita	n
libitinarius	*
libitina_n	f
libones_n	???
libo_n	m
libra	m
libramentum	n
libraria	f
librariolus	m
librarium	n
librarius_1	*
librator	m
libra_n	m
librile	???
librum	n
libui_n	???
libum	n
liburna	f
liburnae_n	???
liburnica	f
liburnica_n	f
liburni_n	*
libya_n	f
libyes_n	3
licentia	f
licentia_n	f
lichas_n	m
licinianus_n	*
licinia_n	n
licinius_n	*
licinus_n	m
licitatio	f
licitator	m
licium	n
lictor	m
licymnia_n	???
lien	???
ligamen	n
ligamentum	n
ligarius_n	*
ligea_n	f
liger_n	m
lignatio	f
lignator	m
lignum	n
ligo_1	
ligula	f
ligures_n	m
liguria_n	f
ligurinus_n	m
ligur_n	*
ligustrum	n
lilium	n
lilybaea_n	???
lilybaeum_n	n
lima	f
limax	2
limbolarius	m
limbus	m
limen	m
limes	m
limetanus_n	m
limnatis_n	f
limus_1	m
limus_2	m
linea	f
lineamentum	n
lingones_n	m
lingonus_n	*
lingua	f
linguarium	n
lingula	???
lingulaca	2
linteo	m
linteolum	n
linter	2
linteum	n
linum	n
linus_n	m
liparenses_n	???
lippitudo	f
liquidum_1	n
liquor_1	
liris_n	m
lis	f
liscus_n	m
lissus_n	m
litauiccus_n	4
liternum_n	n
liticen	m
litigans	???
litigator	m
litigium	n
littera	f
litterator	m
litteratura	f
litterula	f
litura	f
litus	m
litus_n	m
lituus	???
liuia_n	f
liuineius_n	*
liuius_n	*
liuor	m
liuor_n	m
lixa	m
lixa_1	m
locatio	f
locator	m
locellus	m
locrenses_n	???
locris_n	f
locri_n	*
loculamentum	n
loculus	m
locus	m
locusta	2
locusta_n	2
locutio	f
lodicula	f
lodix	f
logos	???
logus	*
loligo	f
loliguncula	f
lolium	n
lollia_n	???
lollius_n	*
lollus_n	4
londinium_n	n
longarenus_n	m
longinquitas	f
longinquum_1	neutre
longinus_n	m
longitudo	f
longum_1	neutre
longurius	m
longus_n	m
loquacitas	f
loquela	f
loquentia	f
lora	f
lorica	f
loricula	f
loripes	*
lorum	n
lorus	m
lotis_n	f
lotium	n
lotophagi_n	*
lotos	f
lubricum	n
lucagus_n	m
lucania_n	f
lucanius_n	*
lucani_n	*
lucanus_n	*
lucar	
luca_n	f
lucceius_n	*
luccius_n	*
lucellum	n
luceres_n	m
luceria_n	f
lucerna	f
lucetius_n	*
lucifer_1	m
lucifer_n	m
lucifuga	f
lucilius_n	*
lucina_n	f
lucius_n	*
lucretia_n	f
lucretilis_n	m
lucretius_n	*
lucrinus_n	*
lucro_n	
lucrum	n
luctamen	n
luctatio	f
luctator	m
lucterius_n	m
luctus	m
luctus_n	m
lucubratio	f
lucullus_n	m
lucus	m
lucus_n	m
ludia	f
ludibrium	n
ludicrum	n
ludificatio	f
ludius	*
ludus	m
ludus_n	m
luela	???
lues	f
lues_n	f
lugdunenses_n	3
lugdunum_n	n
lugii_n	*
lugotorix_n	m
lugubria	???
lumbifragium	n
lumbricus	m
lumbus	m
lumen	n
luminare	n
luna	f
luna_n	f
lunula	m
lupa	f
lupanar	n
lupata	n
lupatria	f
lupercalia_n	n
lupercal_n	n
luperci_n	???
lupercus_n	m
lupia_n	f
lupinum	n
lupinus_1	m
lupus	*
lupus_n	*
lurius_n	*
luror	m
luscinia	f
lusciniola	f
luscinius	*
luscinus_n	m
luscius_n	m
luscus_n	m
lusio	f
lusitania_n	f
lusitani_n	3
lusitanus_n	*
lusius_n	*
lusor	m
lusoriae	f
lustratio	f
lustricius_n	m
lustrum_1	n
lustrum_2	n
lusus	m
lutamentum	n
lutatius_n	*
lutetia_n	f
lutum_1	n
lutum_2	n
lux	*
luxum	n
luxuria	f
luxuria_n	f
luxuries	f
luxus_1	m
luxus_2	m
lux_n	*
lyaeus_n	m
lybia_n	2
lycaeus_n	*
lycambes_n	m
lycaonia_n	f
lycaon_n	m
lychnobius	m
lychnus	m
lycia_n	f
lycidas_n	m
lycii_n	*
lycinna_n	f
lycisca_n	f
lyciscus	m
lycius_n	*
lycomedes_n	m
lycomedius_n	???
lycon_n	f
lycoris_n	f
lycormas_n	m
lycotas_n	m
lycurgus_n	m
lycus_n	m
lydia_n	f
lydi_n	*
lydus_n	*
lygdamus_n	m
lygdus_n	m
lympha	f
lympha_n	f
lyncestae_n	m
lyncestes_n	2
lynceus_n	m
lynx	m
lyra	f
lyra_n	f
lyrica	n
lyrici_1	*
lyrici_2	*
lyristes	m
lyrnessis_n	???
lyrnesus_n	f
lysander_n	m
lysania_n	f
lysiades_n	m
lysias_n	f
lysidicus_n	m
lysimachus_n	m
lysippus_n	m
lysis_n	2
lyson_n	m
ma	f
maccus_n	m
macedones_n	m
macedonia_n	f
macedo_n	m
macellum	n
maceria	f
macer_n	m
machaera	m
machaera_n	m
machina	f
machinamentum	n
machinatio	f
machinator	m
machinatrix	f
macies	f
macies_n	f
macrina_n	2
macrinus_n	m
macritudo	f
macro_n	m
mactator	m
mactatus	m
macula	m
maeander	m
maeander_n	m
maeandrius_n	*
maecenas_n	m
maecenatianus_n	masculin
maecia_n	f
maecilia_n	2
maecius_n	*
maedi_n	*
maelius_n	*
maena	f
maenala_n	n
maenalus_n	m
maenas	m
maenas_n	m
maenius_n	*
maeonia_n	f
maeonidae_n	m
maeonis_n	f
maeon_n	m
maeotis_n	???
maeror	m
maestitia	f
maestitudo	m
maeuia_n	???
maeuius_n	*
maga	f
magalia	f
magetobriga_n	f
magia_n	f
magister	m
magisterium	n
magistra	f
magistratus	*
magius_n	*
magi_n	m
magnanimitas	f
magnes_n	2
magnetes_n	m
magnificentia	f
magnitudo	f
magnum_1	n
magnus_n	*
magus_1	m
magus_n	m
magyni_n	3
maialis	m
maia_n	f
maiestas	f
maiestas_n	f
maiores	m
maius_n	m
mala	f
malaca_n	f
malacia	f
malchus_n	m
malea_n	f
maledictio	f
maledictor	m
maledictum	n
malefactor	m
malefactum	n
maleficium	n
maleuolentia	f
mali	???
malignitas	m
malitia	f
malleolus	m
malleolus_n	m
malleus	m
mallius_n	*
malli_n	*
mallouendus_n	m
mallus	f
mallus_n	f
malobathron	???
malorix_n	m
maltinus_n	m
malua	f
malum_1	n
malum_2	n
malus_1	m
malus_2	m
mamercus_n	m
mamertini_n	3
mamilius_n	*
mamilla	f
mamma	f
mammaea_n	???
mammius_n	4
mamurius_n	m
mamurra_n	m
mamurrius_n	???
manceps	m
mancia_n	m
mancinus_n	*
mancipium	n
mandatum	n
mandatus	m
mandela	f
mandra	f
mandubii_n	*
mandubracius_n	m
manes	2
manes_n	2
mane_1	
mango	m
manica	f
maniculus	m
manii_n	???
manilia_n	f
manilius_n	m
manimi_n	*
manipularis_1	m
manipulus	m
manius_n	*
manlius_n	*
mannicius_n	*
mannulus	m
mannus	m
mannus_n	m
mansuetudo	f
mansuetus_n	*
mantele	???
mantelum	n
mantica	f
mantissa	f
mantua_n	f
manubiae	f
manubrium	n
manuciolum	n
manulearius	m
manumissio	f
manupretium	n
manus_1	m
mapalia	n
mappa	f
maracanda_n	n
marathon_n	*
marathus	m
marathus_n	m
marcellia_n	???
marcellinus_n	???
marcellus_n	*
marcianus_n	*
marcia_n	f
marcius_n	*
marcodurum_n	n
marcomani_n	*
marcor	m
marcus_n	m
mardi_n	*
mardonius_n	m
mare	n
mareoticum_n	neutre
mare_n	n
margarita	f
margarita_n	f
margaritum	n
margiana_n	f
margo	2
marica_n	f
mariccus_n	m
marinus_n	m
marisca	f
marita	f
maritimi	masculin
maritus_1	*
marius_n	*
marmor	m
marmorarius_1	*
maroboduus_n	m
maro_n	m
marra	2
marrucini_n	*
marsaci_n	*
marsaeus_n	m
marsigni_n	*
marsi_n	*
marsupium	n
marsus_n	*
marsyas_n	m
marsya_n	2
mars_n	m
martiales_n	3
martialis_n	2
martigena_n	m
martina_n	???
martiolus	m
martius_n	*
marullus_n	*
marus_n	m
mas	m
mascarpio	m
masinissa_n	m
maso_n	m
massa	2
massagetae_n	m
massa_n	2
massica_n	f
massicum_n	???
massicus_n	m
massilia_n	f
massilienses_n	???
massiua_n	m
massugrada_n	m
massyli_n	*
mastanabal_n	m
mastanesosus_n	m
mastigia	f
mastruca	f
masurius_n	*
matara	f
matella	f
matellio	m
mateola	f
mater	f
matercula	f
materia	f
materies	f
maternus_n	*
matertera	f
mater_n	f
mathematicus_1	*
mathon_n	???
matinus_n	m
matisco_n	m
matius_n	*
matralia_n	???
matricida	m
matrimonium	n
matrinius_n	???
matrona	f
matrona_n	f
mattea	f
mattiaci_n	*
mattium_n	n
matula	f
maturitas	f
maturus_n	*
matuta_n	f
matutinum	n
mauors_n	m
maura_n	f
mauretania_n	f
mauricus_n	???
mauri_n	*
maxilla	f
maximilla_n	2
maximitas	f
maximus_n	*
mazaca_n	f
mazaeus_n	m
mazagae_n	f
mazippa_n	m
mazonomus	m
meatus	m
meculonius_n	*
medates_n	3
medea_n	f
medens	???
mediastinus	m
media_n	f
medicamen	n
medicamentum	n
medicatus_1	m
medica_1	f
medica_2	f
medicina	f
medicus_1	*
medimnum	n
mediocritas	f
mediolanum_n	n
mediomatrici_n	*
medipontus	m
meditamentum	n
meditatio	f
mediterraneum	n
medium	n
medi_n	*
medobriga_n	???
medobrigenses_n	3
medulla	m
medullina_n	???
medullula	f
medusa	f
medusa_n	f
medus_n	*
megaboccus_n	???
megadorus_n	m
megaera_n	f
megalesia_n	n
megalobulus_n	m
megalopolitani_n	???
megara_n	f
megara_o	f
megarea_n	???
megarici_n	*
megaris_n	f
megylla_n	2
meherdates_n	m
mel	n
melampus_n	m
melanippa_n	???
melanthium	n
melanthius_n	m
melanurus	m
mela_n	m
melculum	n
meldi_n	*
meleager_n	m
meliboeus_n	*
melica	f
melicertes_n	m
melichros	m
melimelum	???
melina	f
melinus_n	*
melisphyllum	???
melissa_n	f
melita_n	f
melitenses_n	3
melitensia_n	???
mella_n	f
melliculum	n
mellilla	f
melpomene_n	f
memaceni_n	*
membrana	f
membrum	n
memmiades_n	???
memmius_n	*
memnon_n	m
memorator	m
memoratus_1	m
memoria	f
memphis_n	f
menaeni_n	???
menalcas_n	m
menander_n	m
menapii_n	???
menarchus_n	m
mena_n	f
menda	f
mendacium	n
mendicabulum	n
mendicatio	f
mendicitas	f
mendicus_1	*
mendum	n
menedemus_n	m
menelaus_n	m
menenius_n	*
menestheus_n	m
menetes_n	???
meniscus_n	m
mennius_n	4
menoeceus_n	*
menon_n	???
menophila_n	2
mens	m
mensa	f
mensarius_1	*
mensis	m
mensor	m
menstrua	f
menstruum	n
mensula	f
mensura	f
mens_n	m
menta	f
mentio_1	f
mentor_n	m
mentula	m
mentula_n	m
mentum	n
menulla_n	2
mephitis	f
mercator	m
mercatura	f
mercatus	*
mercedula	f
mercenarius_1	*
merces	f
mercimonium	n
mercurius_n	m
merda	f
meretricula	f
meretrix	f
mereus	4
merga	f
merges	f
mergus	m
mergus_n	m
meridies	f
meritorium	n
meritum	n
merops	m
merops_n	m
merula	2
merula_n	2
merum	n
merx	m
mesochorus	m
mesopotamia_n	f
messala_n	m
messalina_n	???
messalinus_n	???
messalla_n	???
messana_n	f
messapus_n	m
messenii_n	???
messis	f
messius_n	*
messor	m
meta	f
metabus_n	m
metallum	n
metamorphosis_n	f
metanira_n	f
metator	m
metaurum_n	n
meta_n	f
metella_n	f
metellus_n	*
methodium	n
methymnaei_n	???
methymna_n	f
methymniades_n	2
metilius_n	*
metiscus_n	m
metius_n	*
metreta	f
metrodorus_n	*
metronax_n	m
metropolis_n	f
metropolitae_n	m
metropolitae_n	m
metrum	n
mettius_n	*
mettus_n	m
metula	f
metus	m
metus_n	m
meuania_n	f
meuius_n	???
meum	n
meuulanus_n	4
mezentius_n	m
mia	f
mica	f
micipsa_n	m
micon_n	???
midas_n	m
migratio	f
miles	m
milesii_n	*
miletus_n	f
milia	f
miliarium	n
milichus_n	m
militatura	n
militia	f
milium	n
millesima	f
milliarium	n
milonius_n	*
milon_n	???
milo_n	m
miltiades_n	m
milua	f
miluus	4
miluus_n	4
milyae_n	m
mima	f
mimallonides_n	f
mimas_n	m
mimiambi	m
mimnermus_n	m
mimula	f
mimus	m
mina	f
minae	f
minae_n	f
mincius_n	m
minerua_n	f
minicianus_n	4
minicius_n	4
minimum_1	???
minio_n	m
ministerium	n
minister_1	m
ministra	f
ministrator	m
minium	n
minius_n	m
minois_n	f
minos_n	m
minotaurus_n	m
minturnae_n	f
minturnenses_n	???
minucius_n	*
minus	m
minutal	n
minutia	n
minutum	n
minyae_n	m
minyi_n	???
miraculum	n
mirator	m
miratrix	f
mirmillo	m
mirum	neutre
miscellanea	f
miscix	m
misena_n	???
misenum_n	n
misenus_n	???
miseratio	f
miseria	f
misericordia	f
missile	n
missilia	n
missio	f
missus	m
mithrenes_n	m
mithres_n	m
mithridates_n	m
mitra	f
mitulus	m
mixtura	f
mnasistratus_n	m
mnasylus_n	???
mnemosynon	???
mnesilochus_n	m
mnester_n	m
mnestheus_n	m
mobilitas	f
mochus_n	4
moderamen	n
moderatio	f
moderator	m
moderatrix	f
modestia	f
modestus_n	*
modia_n	???
modificatio	f
modiolus	m
modium	n
modius	*
modius_n	*
modulatio	f
modulator	m
modulatus_1	m
modulus	m
modus	m
moecha	f
moechus	m
moenia	n
moenus_n	4
moeris_n	m
moesia_n	f
moesici_n	masculin
moesi_n	*
mogontiacum_n	n
mola	f
molaris_1	m
moles	f
molestia	f
moletrina	f
molile	n
molimen	n
molimentum	n
molitio_1	f
molitor	???
mollimentum	n
mollitia	f
mollities	f
molochinarius	m
molorchus_n	m
molossus_n	*
momen	n
momentum	n
monaeses_n	m
mona_n	f
monedula	f
moneta	f
moneta_n	f
monile	n
monimentum	???
monitio	f
monitor	m
monitum	???
monitus	m
monobazus_n	m
monoecus_n	m
mons	m
monstrator	m
monstrum	n
mons_n	m
montani	m
montanius_n	neutre
montanus_n	*
monumentum	n
monychus_n	m
mopsopia_n	f
mopsus_n	m
mora	f
morator	m
morbus	m
morbus_n	m
mordex	m
moretum	n
morini_n	*
morio	m
moritasgus_n	m
mormyr	f
morositas	f
mors	f
morsus	m
mors_n	f
mortalia	n
mortalis_1	*
mortalitas	f
mortarium	n
mortualia	n
mortuus_1	*
morum	n
morus	m
mos	
mosa_n	2
moschi_n	*
moschus_n	m
moscillus	m
mosella_n	2
mossyni_n	*
mosteni_n	*
motiuncula	f
motus	m
mu	
mucianus_n	*
mucia_n	f
mucius_n	*
mucro	m
mucus	m
mufrius	m
mugilis	???
mugitus	m
mula	f
mulciber_n	m
mulciber_n	m
mulctra	f
mulctrarium	n
mulctrum	n
muliebria	n
mulier	m
mulierarius_1	*
muliercula	f
mulio	m
mullinus_n	4
mullus	m
mulsum	n
multatio	f
multa_1	f
multi	???
multicia	n
multiplicatio	f
multitudo	f
multum_1	n
mulucha_n	2
muluius_n	*
mulus	m
mummius_n	*
munatius_n	*
munda_n	f
mundenses_n	3
munditia	f
munditia_n	f
mundities	f
mundus_1	m
munia	n
municeps	m
municipium	n
munificentia	f
munimen	n
munimentum	n
munitio	f
munitor	m
munius_n	*
munus	n
munusculum	n
muraena	2
murcus_n	m
murena_n	m
murex	???
murgantini_n	???
muria	f
muries	f
murmur	n
murmuratio	f
murobatharius	m
murranus_n	???
murus	m
mus	m
musa	2
musaeus_n	m
musa_n	2
musca	m
muscarium	n
muscipulum	n
musculus	m
muscus	m
musicani_n	*
musica_1	f
musica_2	f
musicus_1	*
musimo	m
musonius_n	*
mustaceum	n
mustaceus	m
mustela	2
mustela_n	2
mustius_n	*
mustum	n
musulamii_n	*
mus_n	m
mutabilitas	f
mutatio	f
muthul_n	m
mutilia_n	2
mutilus_n	m
mutina_n	f
mutitio	f
muto_1	m
mutto_n	m
mutuatio	f
mutusca_n	f
mutus_n	m
mutuum	n
mycenae_n	f
mycena_n	2
mycenis_n	f
myconus_n	f
mylae_n	f
mylasa_n	n
myndii_n	*
myndus_n	f
myrice	f
myrina_n	f
myrmidones_n	m
myropola	m
myropolium	n
myrrha	f
myrrha_n	f
myrrhina_n	2
myrta	f
myrtetum	n
myrtilus_n	m
myrtum	n
myrtus	2
myrtus	2
myrtus	2
mysia_n	f
mysi_n	*
mysta	m
mystagogus	???
mysterium	n
mytilenaei_n	???
mytilenae_n	f
nabalia_n	???
nabarzanes_n	m
nabataei_n	???
nabathes_n	m
nabdalsa_n	m
nablia	n
naeua_n	f
naeuius_n	*
naeuolus_n	4
naeuus	???
nahanaruali_n	*
naias_n	???
nais_n	f
nammeius_n	m
namnetes_n	2
nantuates_n	2
nanus	m
napaeae_n	f
narbo_n	2
narcissus	m
narcissus_n	m
nardum	???
nardus	m
nares	3
naris	???
naristi_n	???
narnia_n	f
narnienses_n	???
naro_n	m
narratio	f
narratiuncula	f
nar_n	m
nasamones_n	2
nasica_n	m
nasidienus_n	???
nasidius_n	masculin
nasiterna	f
naso_n	m
nassa	f
nasta_n	m
nasturtium	n
nasua_n	m
nasum	???
nasus	f
nata	f
natales	*
natalicia	f
natalis_1	m
natalis_n	m
natator	m
natio_1	f
natis	f
natrix	f
natta_n	m
natura	f
natura_n	f
natus_1	*
nauale	n
naualia	n
nauarchus	m
naua_n	f
naucrates_n	m
naucum	n
naufragium	n
naufragus_1	*
nauicula	f
nauicularia	f
nauicularius_1	*
nauigans	n
nauigatio	f
nauigiolum	n
nauigium	n
nauis	f
nauita	m
naulum	n
naumachia	f
naupactus_n	f
naupliades_n	f
nauplius_n	m
nauportum_n	n
nausea	f
nauseator	m
nausiphanes_n	m
nauta	m
nautaca_n	n
nautea	f
nautici	m
naxus_n	f
neaera_n	f
neaerea_n	2
neapolis_n	f
neapolitani_n	???
neapolitanum_n	???
nearchus_n	m
nebris	f
nebula	f
nebulo	
necessarius_1	*
necessitas	f
necessitas_n	f
necessitudo	f
nectar	n
nefarium	n
nefas	n
nefastum	n
negatio	f
neglectio	f
negligentia	n
negotiatio	f
negotiator	m
negotium	n
nemea_n	f
nemesis_n	f
nemetes_n	???
nemetocenna_n	f
nemus	n
nenia	f
neoptolemus_n	m
nepa	f
nepos_1	m
nepos_2	m
nepos_n	m
neptis	f
neptunus_n	m
nequitia	f
nequities	f
neratius_n	*
nereis_n	f
nereus_n	m
nerius_n	m
nero_n	m
nersae_n	f
nerthus_n	f
nerua_n	m
neruia	n
neruii_n	*
nerullinus_n	4
neruus	m
nessus_n	m
nestor_n	m
netini_n	*
netum_n	n
nex	f
nexum	n
nexus	m
nicaea_n	f
nicaeenses_n	3
nicanor_n	m
nicephorium_n	n
nicephorius_n	???
niceros_n	m
niceterium	???
nicetes_n	m
nicobulus_n	m
nicocles_n	m
nicomachus_n	m
nicomedenses_n	???
nicomedes_n	m
nicomedia_n	f
nicon_n	???
nicopolis_n	f
nicostratus_n	*
nidor	m
nidulus	m
nidus	???
niger_n	m
nigidius_n	m
nigrinus_n	???
nigror	m
nihilum	???
nilus_n	m
nimbus	m
nimium_1	n
ninguis	f
ninnius_n	*
ninus_n	m
niobe_n	f
niphaeus_n	m
niseis_n	f
nisus	m
nisus_n	m
nitedula	f
nitiobroges_n	2
nitor_1	m
nitrum	n
nix	f
nixus	m
nobilior_n	???
nobilis_1	f
nobilitas	f
noctiluca_n	f
noctua	f
nocturnus_n	m
nodus	m
nolani_n	???
nola_n	f
nomades_n	2
nomen	n
nomenclator	m
nomenculator	???
nomentanum_n	neutre
nomentanus_n	*
nomentum_n	n
nominatio	f
nominatus_n	*
nomus	m
nonae	f
nonianus_n	4
nonius_n	*
norbanus_n	*
noreia_n	f
norenses_n	???
norica_n	???
norici_n	*
noricum_n	n
norma	f
nortia_n	f
nota	f
notarius_1	*
notatio	f
nothus_n	m
noti	3
notio	f
notitia	f
notities	f
noti_n	3
notor	m
notus_1	*
notus_n	*
nouacula	f
nouaesium_n	???
nouale	n
nouaria_n	f
nouatilla_n	???
nouatus_n	m
nouellus_n	*
nouerca	f
nouia_n	f
nouiodunum_n	n
nouitas	f
nouius_n	*
nox	f
noxa	f
noxia	???
nox_n	f
nubecula	f
nubes	f
nubigena	m
nubila	n
nubilum	n
nuceria_n	f
nucerini_n	???
nucerinus_n	masculin
nucifrangibulum	n
nucleus	m
nucula_n	2
nugae	f
nugator	m
nugigerulus	m
nuitones_n	3
numantia_n	f
numantina_n	2
numantini_n	*
numanus_n	???
numa_n	m
numella	f
numen	n
numenius_n	*
numeratio	f
numeratum	n
numerius_n	*
numerus	m
numicius_n	*
numicus_n	*
numidae_n	m
numida_n	m
numidia_n	f
numidicus_n	*
numisius_n	*
numitoria_n	???
numitorius_n	???
numitor_n	m
nummularius_1	*
numulariolus	m
numulus	m
numus	m
nuncupatio	f
nundinae	f
nundinatio	f
nuntia	f
nuntiatio	f
nuntium	n
nuntius_1	*
nupta	f
nuptiae	f
nuptus	m
nursia_n	f
nurus	m
nutatio	f
nutricium	n
nutricius_1	*
nutricula	f
nutrimentum	n
nutrix	f
nutus	m
nux	f
nyctelius_n	*
nympha	f
nymphaeum_n	n
nympha_n	f
nymphidius_n	???
nymphodorus_n	m
nymphon_n	m
nysa_n	f
nysigena_a	???
nysius_n	???
obaeratus_1	*
obaritus_n	m
obba	f
obductio	f
obedientia	f
obex	2
obiecta	???
obiectatio	f
obiectus	m
obitus	m
obiurgatio	f
obiurgator	m
oblectamentum	n
oblectatio	f
obliquitas	f
obliquum_1	neutre
obliuio	f
obliuio_n	f
obliuium	n
obrogatio	f
obrussa	f
obscena	???
obscenitas	f
obscenum	n
obscuratio	f
obscuritas	f
obscurum_1	n
obsecratio	f
obsequela	f
obsequentia	f
obsequium	n
obseruantia	f
obseruatio	f
obseruator	m
obses	m
obsessio	f
obsessor	m
obsidio	
obsidium_1	n
obsidium_2	n
obsignator	m
obsonator	m
obsonatus	m
obsonium	n
obstantia_2	f
obstetrix	f
obstinatio	f
obstructio	f
obtentus	m
obtestatio	f
obtrectatio	f
obtrectator	m
obtutus	m
obucula_n	???
obultronius_n	*
occasio	f
occasus	m
occatio	f
occator	m
occia_n	???
occidens	???
occidens_n	???
occidio	f
occipitium	n
occiput	n
occisio	f
occultatio	f
occultator	m
occultum	???
occupatio	f
occupo_n	m
occursatio	f
occursus	m
oceanitis_n	f
oceanus_1	m
oceanus_n	m
ocella_n	m
ocellus	m
ocelum_n	n
ochus_n	m
ocimum	???
ocinum	n
oclopeta	f
ocnus_n	m
ocrea	f
ocrea_n	f
ocresia_n	f
ocriculanum_n	neutre
ocriculum_n	n
octauae	f
octauiani_n	3
octauianus_n	*
octauia_n	???
octauius_n	*
octauus_n	*
october_n	m
octodurus_n	m
octophoron	n
octuplum	n
octussis	m
oculus	m
odarium	n
odium	n
odor	m
odrysae_n	m
odyssea_n	f
oeagrus_n	m
oebalia_n	f
oebalidae_n	m
oebalus_n	m
oechalia_n	f
oeconomicus_n	*
oedipus_n	m
oedipus_n	m
oeenses_n	???
oenone_n	f
oenophorum	n
oenopolium	n
oenothea_n	f
oeobazus_n	4
oestrus	???
oesypum	n
oeta_n	f
ofella	f
ofellus_n	???
offa	f
offendiculum	n
offensa	f
offensatio	f
offensio	f
offensiuncula	f
offensus_1	m
officina	f
officiosus_1	*
officium	n
offla	???
offucia	f
ofonius_n	m
ogulnia_n	???
oileus_n	m
olea	f
olearius_1	*
olearus_n	f
oleaster	m
oleitas	f
olelus_n	4
olennius_n	m
oletum_1	n
oletum_2	n
oleum	n
olitio	f
olitor	???
oliua	f
oliuetum	n
oliuum	n
olla	f
ollius_n	*
ollouico_n	m
olor_1	m
olor_2	m
olus	m
olusculum	n
olympeni_n	*
olympias_n	f
olympia_n	f
olympia_o	f
olympiscus_n	???
olympus_n	m
olynthus_n	2
omasum	n
ombi_n	m
omen	n
omentum	n
ominator	m
omphis_n	m
onager	m
onagus_n	???
onasus_n	m
onchae_n	f
oneraria	f
oneraria	f
onesicritus_n	m
onomastus_n	*
onus	n
opacitas	f
opacum	neutre
opella	f
opera	f
operaria	f
operarius_1	*
operculum	n
operimentum	n
opertorium	n
opertum	n
ophiuchus_n	m
ophthalmia	f
opifex	m
opilio	m
opimianum_n	???
opimitas	f
opimius_n	*
opinatus	*
opinio	f
opistographus	4
opis_n	f
opitergium_n	n
opobalsamum	n
oppianicus_n	*
oppia_n	???
oppidani	*
oppidanus_1	*
oppidius_n	*
oppidulum	n
oppidum	n
oppius_n	*
opportunitas	f
oppositus_1	m
oppressio	f
oppressus	m
opprobrium	n
oppugnatio	f
oppugnator	m
ops	f
opsius_n	*
ops_n	f
optatio	f
optatum	n
optimates	m
optimus_n	*
optionatus	m
optio_1	m
optio_2	m
opulentia	f
opusculum	n
opus_1	f
opus_2	f
ora	f
oraculum	n
orata_n	m
oratio	f
oratiuncula	f
orator	m
oratus	m
ora_n	f
orbatio	f
orbiculus	m
orbilius_n	*
orbis	m
orbita	f
orbitas	f
orbius_n	*
orca	m
orchestra	f
orchitis	f
orchiuius_n	???
orchomenus_n	???
orcula	f
orcus_n	m
orcynia_n	2
ordinatio	f
ordinator	m
ordo	m
ordouices_n	2
oreades_n	f
oreae	f
orestae_n	m
orestes_n	m
orestes_n	m
orestes_n	m
orestilla_n	???
orestis_n	f
orexis	f
orfidius_n	4
orfitus_n	*
organicus_1	*
organum	n
orgetorix_n	m
orgia	f
orichalcum	n
oricum_n	n
oriens	m
oriens_n	m
origines_n	f
origo	f
origo_n	f
orion_n	m
orithyia_n	f
ormenus_n	???
ornamentum	n
ornatrix	f
ornatus_1	m
ornus	m
ornytus_n	m
orontes_n	m
orpheus_n	m
orpheus_n	m
orsa	f
orsilochus_n	m
ortus	m
ortygia_n	f
ortygius_n	masculin
oryx	m
oryza	f
oscen	m
oscenses_n	???
oscillatio	f
oscillum_1	n
oscitatio	f
osci_n	*
osculatio	f
osculum	n
osinius_n	m
osiris_n	m
osismi_n	*
osi_n	*
osor	m
ossa_n	f
ossiculum	n
ossifraga	f
ostentatio	f
ostentator	m
ostentum	n
ostentus	m
ostiarium	n
ostiarius	*
ostia_n	f
ostia_n	f
ostiolum	n
ostium	n
ostorius_n	*
ostreum	n
ostrum	n
os_1	f
os_2	f
otacilius_n	*
otho_n	m
othryades_n	m
othrys_n	m
otium	n
otogesa_n	2
ouidius_n	*
ouile	n
ouilla	f
ouis	m
ouius_n	*
ouum	n
oxartes_n	m
oxathres_n	???
oxionae_n	2
oxus_n	m
oxyartes_n	m
oxycominum	n
oxymeli	n
pabulatio	f
pabulator	m
pabulum	n
pacarius_n	m
pacator	m
paccius_n	*
pacensis_n	2
pacenus_n	m
pachynum_n	n
paciaecus_n	m
pacideianus_n	???
pacideius_n	4
pacideus_n	4
pacilius_n	*
pacius_n	*
paconianus_n	m
paconius_n	m
pacorus_n	m
pacta	f
pactio	f
pactolus_n	m
pactum	n
pactumeus_n	4
pacuuius_n	*
padua_n	f
padusa_n	f
padus_n	m
paean_n	m
paedagogium	n
paedagogus	m
paedor	m
paegnium_n	???
paeligni_n	*
paelignus_n	4
paenitentia	f
paenula	f
paeones_n	2
paeonia_n	f
paestum_n	n
paetina_n	???
paetus_n	m
paganus_1	m
pagasa_n	f
pagasus_n	m
pagina	f
pagus	m
pagyda_n	m
pala	f
palaemon_n	m
palaepharsalus_n	f
palaestra	f
palaestrita	???
palamedes_n	m
palatium	n
palatium_n	n
palatum	???
palea	f
palear	n
pales_n	???
palfurius_n	m
palicanus_n	m
palicus_n	???
palilia_n	n
palinurus_n	m
paliurus	???
palla	f
pallacine_n	f
palladium_n	n
pallanteum_n	n
pallantis_n	f
pallas_n	m
pallas_o	m
palla_n	f
palliolum	n
pallium	n
pallor	m
palma	f
palmes	m
palmetum	n
palmula	f
palmulus	m
palmus	m
palmus_n	m
palpebrae	f
palpellius_n	m
palpitatio	f
palpum	???
paludamentum	n
palumbes	m
palumbus	m
palus_1	f
palus_2	f
pammenes_n	m
pamphila_n	f
pamphilus_n	*
pamphylia_n	f
pampinus	m
panacea	f
panaetius_n	m
panarium	n
panathenaicus_n	*
panax	???
panchaia_n	f
pancharia_n	2
pancration	???
pandarus_n	m
pandateria_n	f
panda_n	f
pandion_n	m
pandusa_n	???
panes_n	m
pangaea_n	???
pangaeus_n	*
panhormitani_n	masculin
panhormus_n	f
panici_n	3
panicum	n
panis	m
panniculus	m
pannonia_n	f
pannonici_n	masculin
pannonii_n	???
pannucia	???
pannus	m
panopea_n	???
pansa_n	m
pantagias_n	m
panthera_1	f
panthus_n	???
pantilius_n	m
pantolabus_n	m
pantomima	f
pantomimus	m
pantuleius_n	m
panurgus_n	m
pan_n	m
papauer	m
paphlagona_n	2
paphlagones_n	m
paphlagonia_n	f
paphus_n	f
papia_n	???
papilla	f
papinius_n	*
papirius_n	*
papirus_n	m
papius_n	*
pappus	???
papula	f
papus_n	m
papyrus	f
parabola	f
parada_n	f
paradoxum	???
paraetacene_n	f
paraetonium_n	n
paralus_n	m
paralyticus	m
parapamisadae_n	???
parapanisus_n	4
pararius	*
parasita	f
parasitatio	f
parasitus	m
parastata	m
parata	f
paratio	f
paratus_1	m
parca_n	f
parcitas	f
pardalis	f
pardalisca_n	???
pardus	*
parens_1	m
parentalia	n
parentani_n	*
parentes	???
parenticida	m
paries	m
parilia_n	n
parisii_n	*
paris_n	m
parium_n	n
parma	f
parma_n	f
parmenides_n	m
parmenion_n	???
parmenses_n	???
parmula	f
parnasus_n	m
parnethus_n	4
parochus	???
paronychia	n
paropsis	f
parra	f
parraces_n	m
parrhasius_n	*
parrhesiastes_n	???
parricida	???
parricidium	n
pars	f
parsagada_n	???
parsimonia	f
parthenius_n	*
parthenopaeus_n	m
parthenope_n	f
parthia_n	f
parthieni_n	3
parthini_n	???
parthi_n	*
parthyaei_n	*
particeps_1	*
particula	f
partitio	f
partitudo	f
partum	n
partus_1	m
parum_1	n
parus_n	*
paruum	???
paruus_1	*
par_1	???
pasceolus	m
pascuum	n
pasippus_n	4
pasithea_n	f
pasitigris_n	m
passennus_n	m
passer	m
passerculus	m
passienus_n	m
passum	n
passus_1	m
pastillus	m
pastio	f
pastor	m
pastor_n	m
pastus	m
patagiarius	m
patalia_n	f
pataracinum	n
patauini_n	???
patauium_n	n
patella	f
pater	m
patera	m
pater_n	m
patibulum	n
patientia	f
patina	m
patina_n	m
patisius_n	m
patrator	m
patria	f
patria_n	f
patricius_1	*
patrimonium	n
patrobius_n	m
patrocinium	n
patrocles_n	m
patrona	f
patronus	m
patron_n	m
patruelis_1	*
patruitus_n	4
patruus_1	*
patulcius_n	m
pauca	f
pauci	m
paucitas	f
paucuuius_n	4
pauicula	f
pauimentum	n
paulina_n	???
paulinus_n	*
paullus_n	*
paululum_1	???
paulum_1	???
paulus_n	m
pauo	m
pauor	m
pauor_n	m
pauperies	f
paupertas	f
pausa	f
pausanias_n	m
pausarius	m
pausea	f
pauxillum_1	n
pax	f
paxaea_n	???
pax_n	f
peccans	???
peccatum	n
pecoli_n	3
pecten	
pectus	n
pecu	n
pecuaria	f
pecuarius_1	*
peculator	m
peculatus	m
peculium	n
pecunia	f
pecunia_n	f
pecus_1	f
pecus_2	f
pedale	n
pedanius_n	*
pedatum	n
pedatus_1	*
pedes	m
pediatia_n	m
pedica	f
pedicellus	m
pedicinus	*
pediculus_1	m
pedis	f
pedisequa	f
pedisequus	*
peditatus_1	*
peditum	n
pedius_n	*
pedo_n	m
peducaeus_n	*
pedum	n
pegasides_n	???
pegasus_n	m
pegma	n
pelagon_n	???
pelagus	m
pelagus	m
pelamis	f
pelasgi_n	*
pelasgus_n	masculin
pelastes	3
pelethronium_n	n
peleus_n	m
peleus_n	m
pelias_n	f
pelides_n	m
pelion_n	n
pellacia	f
pellex	f
pellicatus	m
pellicula	f
pelliculatio	f
pellio_n	m
pellis	f
pelopea_n	f
peloponnenses_n	???
peloponnesii_n	???
peloponnesus_n	f
pelops_n	m
pelorias_n	f
peloris	f
peloris_n	f
pelorus_n	m
pelta	f
peluis	f
pelusium_n	n
penates	m
penates_n	m
penator	m
peneleus_n	m
penelope_n	f
penetrale	???
peneus_n	*
penicillum	???
penis	m
penna	f
pennipotentes	3
pennus_n	m
pensatio	f
pensio	f
pensum	n
penteremis	f
penteres	f
penthesilea_n	f
pentheus_n	*
penuria	f
penus	n
penus	n
penus	n
peplus	???
pera	m
peractio	f
peragratio	f
peratus	*
perbibesia_n	???
perca	f
percennius_n	m
perceptio	f
percontatio	f
percontator	m
perculsus	m
percunctatio	???
percursatio	f
percussio	f
percussor	m
percussus	m
perdiccas_n	???
perditor	m
perductor	m
perduellio	f
perduellis	m
peredia_n	f
peregrinatio	f
peregrinus_1	*
perellius_n	4
peremptor	m
perenna_n	f
perfectio	f
perfidia	f
perfidia_n	f
perflatus	m
perfuga	m
perfugium	n
pergama_n	2
pergameni_n	???
pergamum_n	n
pergamus_n	f
perga_n	f
pergula	f
peribomius_n	???
pericles_n	m
pericles_n	m
periculum	n
peridia_n	2
perilaus_n	m
perillus_n	*
perinthus_n	f
periodus	m
peripatetici_n	*
peripateticus_1	???
peripetasma	n
peripetasma	n
periphanes_n	???
periphanes_n	???
periphas_n	m
periplanes_n	3
periscelis	f
peristasis	f
peristroma	n
peristylium	n
peristylum	???
peritia	f
periurium	???
perlecebra	???
permagnum	???
permessus_n	m
permissus_1	m
permixtio	f
permutatio	f
perna	f
pernicies	f
pernicitas	f
pernula	f
pero	f
perpauci	masculin
perpendiculum	n
perpenna_n	m
perperna_n	m
perpessio	f
perpetuitas	f
perpotatio	f
perrhaebia_n	f
persae_n	2
persalutatio	f
perscriptio	f
perscriptor	m
perscrutatio	f
persephone_n	f
persepolis_n	f
perses_n	m
perses_n	m
perses_n	m
perseuerantia	f
perseus_n	*
persicum	???
persicus_n	*
persis_n	m
persius_n	m
persolla	f
persona	f
perspicientia	f
persuasio	f
persuastrix	f
persuasus	m
pertica	f
pertinacia	f
perturbatio	f
peruersitas	f
peruersum	
peruicacia	f
peruigilium	n
peruium	n
perula	f
perusia_n	f
perusinum_n	???
pes	m
pessinus_n	f
pessulus	m
pestilentia	f
pestilitas	f
pestis	f
pestis_n	f
petasunculus	m
petasus	m
petauristarius	m
petaurum	n
petelia_n	f
petelini_n	???
petilius_n	*
petillius_n	???
petitio	f
petitor	m
petitus	m
petoritum	n
petosiris_n	m
petra	f
petraeus_n	*
petraites_n	3
petra_n	f
petreius_n	*
petreus_n	*
petrini_n	*
petrinum_n	n
petro	m
petrocorii_n	*
petronia_n	f
petronius_n	*
petrosidius_n	m
pettius_n	*
petulantia	f
petusius_n	4
peucini_n	*
peucolaus_n	m
phaeaces_n	2
phaeacia_n	f
phaecasia	f
phaecasium	n
phaedra_n	f
phaedria_n	m
phaedromus_n	4
phaedrus_n	m
phaethontiades_n	f
phaethon_n	m
phager	m
phalacrus_n	m
phalangae	f
phalanthus_n	???
phalanx	f
phalaris_n	m
phalerae	f
phaleris_n	f
phantasia	f
phantasma	n
pharasmanes_n	m
pharetra	m
pharitae_n	m
pharius_n	*
pharmacopola	???
pharmacus_n	m
pharnabazus_n	m
pharnaces_n	m
pharos_n	???
pharsalia_n	f
pharus_n	f
phaselis_n	f
phaselitae_n	???
phaselus	m
phasis_n	m
pheneum_n	n
pheneus_n	m
pheretiades_n	m
pheronactus_n	4
phiala	f
phidippus_n	m
philadelpheni_n	*
philadelphus_n	m
philaeni_n	m
philargyrus_n	m
phileros_n	m
philetas_n	m
philinus_n	m
philippa_n	???
philippenses_n	3
philippi_n	m
philippopolis_n	f
philippus_n	m
philocrates_n	m
philocrates_n	m
philocteta_n	m
philoctetes_n	???
philodamus_n	m
philodemus_n	m
philodorus_n	m
philologia	f
philologus_1	m
philomela_n	f
philomelienses_n	2
philomelium_n	n
philon_n	???
philopator_n	m
philopolemus_n	???
philositus_n	m
philosophia	f
philosophus_1	m
philotas_n	m
philoxenus_n	m
philtrum	n
philus_n	m
philyra	f
phimus	m
phineus_n	m
phinides_n	m
phintias_n	m
phintia_n	f
phlegethon_n	m
phlegra_n	f
phlyus_n	4
phoca	f
phocaei_n	???
phocii_n	*
phocis_n	f
phocus_n	m
phoebigena_n	m
phoebus_n	m
phoenices_n	2
phoenicopterus	m
phoenissae_n	???
phoenissa_n	f
phoenix	m
phoenix_n	m
pholus_n	m
phonascus	m
phorbas_n	m
phorcus_n	m
phoronis_n	f
phosphorus_n	m
photinus_n	*
phraates_n	m
phradates_n	m
phrataphernes_n	m
phrenesis	f
phrixus_n	m
phrugia_n	2
phryges_n	m
phrygia_n	f
phthia_n	f
phthiotes_n	???
phthisis	f
phylaca	f
phylacides_n	m
phylarchus_n	m
phyllis_n	f
piaculum	n
piamen	n
piamentum	n
pica	m
picea	f
picens_n	*
picentes_n	3
picenum_n	n
pictones_n	m
pictor	m
pictura	f
picus	m
picus_n	m
pieris_n	f
pietas	f
pietas_n	f
pietaticultrix	f
pigmentum	n
pignerator	m
pignus	n
pigritia	f
pilanus	m
pilatus_n	m
pila_1	2
pila_2	2
pilentum	n
pileolus	m
pileum	n
pileus	m
pilicrepus	m
pilum	n
pilumnus_n	m
pilus_1	m
pilus_2	m
pinacotheca	f
pinarius_n	*
pinarus_n	m
pindarus_n	m
pindus_n	m
pinetum	n
pingue	n
pinguitudo	f
pinna	f
pinnirapus	m
pinnula	f
pinthia_n	???
pinus	m
pinus	m
pinus	m
pipa_n	f
piper	m
pipulum	???
piraea_n	???
piraeeus_n	m
piraeus_n	???
pirata	m
piratica	f
pirene_n	f
pirithous_n	m
pirum	n
pirus	m
pirustae_n	m
pisae_n	f
pisander_n	m
pisanus_n	*
pisatio	f
pisaurum_n	n
pisa_n	f
piscator	m
piscatus	m
pisces_n	m
pisciculus	m
piscina	f
piscis	f
piscis_n	f
pisidae_n	m
pisidia_n	f
pisistratus_n	m
piso_n	m
pistillum	???
pistoclerus_n	???
pistor	m
pistorenses_n	3
pistor_n	m
pistrinum	n
pistris	f
pistrix	f
pisum	n
pittacium	n
pituanius_n	???
pituita	f
pius_n	*
pix_1	f
pix_2	f
placabilitas	f
placamentum	n
placenta	f
placentia_n	f
placentini_n	???
placidus_n	m
placitum	n
plaetorius_n	*
plaga_1	f
plaga_2	f
plaga_3	f
plagiarius	*
plagipatida	???
plaguleius_n	m
planasia_n	f
plancina_n	???
plancius_n	*
planctus	m
plancus_n	m
planesium_n	n
plangor	m
planipes	m
planitas	f
planities	f
planta	m
plantaria	n
planta_n	m
planum	n
planus_1	*
plasma	f
plataeae_n	f
platagidorus_n	m
platanus	f
platanus	f
platea_1	f
platonici_n	???
platon_n	m
plator_n	m
plausor	m
plaustellum	n
plaustrum	n
plaustrum_n	n
plausus	m
plautius_n	*
plautus_n	m
plebecula	f
plebeius_1	*
plebicola	m
plebiscitum	n
plebitas	f
plebs	f
plebs	f
plebs	f
plectrum	n
pleiades_n	f
pleias_n	???
plenum	???
plerique	masculin
pleumoxii_n	*
pleuratus_n	m
plias_n	f
plinius_n	*
plisthenes_n	m
plocamus_n	???
ploratus	m
plotina_n	f
plotius_n	*
ploxemum	n
pluma	f
plumbeum	n
plumbum	n
plurimum	neutre
plusculum_1	n
pluteus	m
pluton_n	???
pluuia	f
pocillum	n
poculum	n
podagra	f
podalirius_n	m
podex	m
podium	n
poeas_n	m
poema	n
poema	n
poema	n
poematium	n
poena	f
poena_n	f
poenius_n	???
poeni_n	*
poesis	f
poeta	???
poetica	???
poetouio_n	m
poetria	f
poleas_n	m
polemarchus_n	m
polemocrates_n	m
polemon_n	m
polenta	f
politor	m
politura	f
pollen	n
pollentia	f
pollentia_n	f
pollex	m
pollicitatio	f
pollicitum	n
pollinctor	m
pollio_n	m
pollitta_n	f
pollux_n	m
polus	m
polyaenus_n	m
polybius_n	m
polybus_n	m
polycletus_n	m
polyclitus_n	???
polydamas_n	m
polydorus_n	m
polyhymnia_n	f
polymestor_n	m
polypemon_n	???
polypercon_n	m
polyphemus_n	m
polypus	m
polystratus_n	m
polytimetus_n	m
polyxena_n	f
pomarium	n
pomarius_1	*
pomeiani_n	3
pomeia_n	2
pomerium	n
pometia_n	f
pometii_n	*
pompa	f
pompeiani_n	???
pompeianus_n	*
pompeia_n	f
pompeii_n	m
pompeiopolis_n	f
pompeius_n	*
pompei_n	m
pompilius_n	*
pompilus	???
pomponianus_n	*
pomponia_n	???
pomponius_n	*
pomptinus_n	*
pompulenus_n	4
pomum	n
pomus	m
pondo	n
pondus	n
pons	m
pons_n	m
pontia_n	f
pontici_n	3
ponticulus	m
ponticus_n	*
pontifex	m
pontificatus	m
pontius_n	*
ponto	
pontus	m
pontus_n	m
popa	m
popanum	n
popellus	m
popilius_n	*
popina	f
popino	m
poples	m
poppaea_n	f
poppaeus_n	*
popularis_1	m
popularitas	f
populatio	f
populator	m
populiana_n	2
populonia_n	f
populus_1	m
populus_2	m
porca	f
porcellus	m
porcina	f
porcinarius	m
porcinum	n
porcius	*
porcius_n	*
porculus	m
porcus	m
porrigo_1	
porrima_n	f
porrina	f
porrum	n
porrus	m
porsena_n	m
porsenna_n	???
porta	f
portatio	f
portentum	n
porticanus_n	m
porticus	m
porticus_n	m
portio	f
portisculus	m
portitor_1	m
portitor_2	m
portorium	n
portunus_n	m
portus	m
porus_n	m
posidonius_n	*
posidorus_n	4
positio	f
positor	m
positura	f
positus	*
possessio	f
possessor	m
posteri	m
posteritas	f
posticum	n
postilena	f
postilio	f
postis	m
postliminium	n
postuerta_n	f
postulatio	f
postulatum	n
postumia_n	???
postumina_n	2
postuminus_n	4
postumius_n	*
postumus_n	*
potatio	f
pota_n	n
potentatus	*
potentia	f
potentia_n	f
potestas	f
potio_1	
potitius_n	???
potitus_n	m
potiuncula	f
potniades_n	f
potor	m
potus_2	m
praebitor	m
praecentio	f
praeceps_1	*
praeceptio	f
praeceptor	m
praeceptum	n
praecipitatio	f
praeco	m
praeconinus_n	m
praeconium	n
praecordia	n
praecursio	f
praecursor	m
praeda	f
praedatio	f
praedator	m
praediator	m
praedicatio	f
praedicator	m
praedictio	f
praedictum	n
praediolum	n
praedium	n
praedo	
praedonulus	m
praefatio	f
praefectura	f
praefectus	m
praefurnium	n
praegressus	m
praegustator	m
praeiudicatum	???
praeiudicium	n
praelusio	f
praemium	n
praeneste_n	n
praenomen	n
praenuntia	n
praenuntius_1	*
praeparatio	f
praepes_1	*
praepositio	f
praepositus_1	m
praepotentes	???
praeputium	n
praerogatio	f
praerogatiua	f
praerupta	n
praesaepe	???
praesaepes	f
praesagium	n
praescriptio	f
praescriptum	n
praesegmen	n
praesentia_1	f
praesentia_2	f
praesepis	???
praeses	m
praesidens	m
praesidium	n
praestantia	f
praestatio	f
praestigiae	f
praestigiator	m
praestigiatrix	f
praesti_n	*
praestutiani_n	3
praesumptio	f
praes_1	m
praeterita	???
praeteritum	neutre
praetermissio	f
praeteruectio	f
praetexta	f
praetextata_n	2
praetextum	n
praetextus_1	m
praetor	m
praetorium	n
praetorius_1	*
praetura	f
praeuaricatio	f
praeuaricator	m
praexaspes_n	???
pragmaticus_1	*
prandium	n
prasii_n	*
prasutagus_n	m
pratulum	n
pratum	n
prauitas	f
praxis	f
praxiteles_n	m
precatio	f
precator	m
preciae	???
prelum	n
pressio	f
pretium	n
prex	f
priameis_n	f
priamus_n	m
priapus	m
priapus_n	m
prilius_n	4
primani	m
prima_1	f
prima_n	f
primigenius_n	*
primipilaris	*
primipilus	m
primitiae	f
primordium	n
primores	m
primus_n	*
princeps_1	m
principatus	*
principium	n
priores	3
prisca_n	???
prisci	3
priscinus_n	m
prisci_n	3
priscus_n	*
pristis	f
pristis_n	f
priuernum_n	n
priuernus_n	*
priuienus	4
priuigna	f
priuignus	m
priuilegium	n
proagorus	m
proauia	f
proauus	m
probatio	f
probator	m
probitas	f
proboscis	f
probrum	n
probus_n	*
procacitas	f
procas_n	m
procella	f
procer	m
proceres	m
proceritas	f
processus	m
prochyta_n	f
procilla_n	???
procillus_n	*
procinctus_1	m
procliue_1	n
procliuitas	f
procne_n	f
procoeton	m
proconsul	m
proconsulatus	m
procrastinatio	f
procris_n	f
procula_n	f
proculcatio	f
proculeius_n	m
proculus_n	*
procuratio	f
procuratiuncula	f
procurator	m
procursus	m
procus	m
prodicus_n	m
prodigentia	f
prodigium	n
proditio_1	f
proditio_2	f
proditor	m
producta	n
proeliator	m
proelium	n
proetides_n	???
proetus_n	m
profatus	m
profectio	f
profectus	m
professio	f
professor	m
profligator	m
profluuium	n
profugus_1	*
profundum	n
profusio	f
progener	m
progenies	f
progressio	f
progressus_1	m
prohibita	f
prohibitio	f
proiectus_1	m
prolapsio	f
prolatio	f
proles	f
prologus	m
prolusio	f
proluuies	f
promeritum	???
prometheus_n	*
prominens_1	???
promiscuum	neutre
promissio	f
promissor	m
promissum	n
promolus_n	???
promontorium	n
promonturium	n
promptus_1	*
promulgatio	f
promulsidare	???
promulsis	f
promus	m
pronepos	m
proneptis	f
pronuba	f
pronuntiatio	f
pronurus	f
prooemium	n
propagatio	f
propago_1	
propatulum	n
properantia	f
propertius_n	*
propinatio	f
propinqui	???
propinquitas	f
propinquum	???
propinquus_n	*
propola	m
propontis_n	f
propositio	f
propositum	n
propraetor	m
proprietas	f
proprium	n
propudium	n
propugnaculum	n
propugnatio	f
propugnator	m
propulsatio	f
propylaeum	???
proquaestor	m
prora	f
proris	f
prosapia	f
proscaenium	n
proscenium	???
proscriptio	f
prosecta	f
proserpina_n	f
proseucha	f
prosocer	m
prospectus	m
prospera	???
prosperitas	f
prospicientia	f
prostibulum	n
prostituta	f
protagoras_n	m
protelum	n
proteruitas	f
protesilaus_n	m
proteus_n	m
prothous_n	???
protogenes_n	m
prouentus	m
prouerbium	n
prouidentia	f
prouincia	f
prouincialis_1	m
prouisio	f
prouisor	m
prouisus	m
prouocatio	f
prouocator	m
proxeneta	m
proximitas	f
proximum	???
proxumus_n	masculin
prudentia	f
pruina	f
pruna	f
prunum	n
prunus	f
prurigo	f
prusa_n	f
prusenses_n	???
prusiada_n	???
prusias_n	f
prytaneum	n
prytanis	m
prytanis_n	m
psalterium	n
psaltria	f
psephisma	n
pseudolus_n	m
pseudophilippus_n	m
pseudothyrum	n
psittacus	m
psychroluta	m
psyllus	???
psythia	???
pterelas_n	m
pterela_n	???
ptianii_n	3
ptisanarium	n
ptolemaeus_n	m
ptolemais_n	f
ptolomaeus_n	4
pubertas	f
publica	f
publicanus_1	m
publicatio	f
publicius_n	*
publicola_n	m
publicum	n
publicus_1	m
publicus_n	m
publilius_n	*
publius_n	*
pudenda	???
pudens_n	m
pudicitia	f
pudicitia_n	f
pudor	m
pudor_n	m
puella	f
puellarius	*
puella_n	f
puellula	f
puellus	m
puer	m
puerilitas	f
pueritia	f
puerpera	f
puerperium	n
puerulus	m
puga	f
pugil	m
pugilatus	m
pugillar	n
pugillares	m
pugillus	m
pugio	m
pugiunculus	m
pugna	f
pugnacitas	f
pugnator	m
pugnum	???
pugnus	m
pulcher_n	m
pulchralia	n
pulchra_n	n
pulchritudo	f
pulex	m
pulfenius_n	4
pullarius_1	*
pullia_n	2
pullo_n	
pullum	n
pullus_1	m
pulmentarium	n
pulmentum	n
pulmo	m
pulpa	f
pulpamentum	n
pulpitum	n
puls	f
pulsatio	f
pulsus	m
pultarius	m
puluillus	m
puluillus_n	m
puluinar	n
puluinus	m
puluis	2
pumex	m
pumilio	2
punctatoriola	f
punctiuncula	f
punctum	n
punitor	m
pupa	f
pupilla	f
pupillus	m
pupinia_n	f
pupius_n	*
puppis	f
pupula	f
pupulus	m
purgamen	n
purgamentum	n
purgatio	f
purpura	f
purpuratus_1	*
pus	
pusilla_n	???
pusillum_1	???
pusio	f
pusio_n	f
pusula	f
putamen	n
putatio	f
putator	m
puteal	
puteal_n	
puteolani_n	???
puteoli_n	m
puteus	m
putillus	*
putor	m
pygargus	m
pygmalion_n	m
pylades_n	m
pyladus_n	4
pylae_n	f
pylus_n	4
pyra	f
pyragrus_n	4
pyramis	f
pyramis_n	f
pyramus_n	m
pyrenaeus_n	*
pyrethrum	???
pyrgi_n	m
pyropus	m
pyrrha_n	f
pyrrhiades_n	???
pyrrhonei_n	???
pyrrhus_n	m
pyrria_n	2
pyrrichus_n	m
pythagoras_n	m
pythagorei_n	???
pythia_n	n
pythia_o	n
pythius_n	*
pythodorus_n	m
pytisma	n
pyxis	f
quadi_n	*
quadra	m
quadragesima	f
quadrans	m
quadrantal	n
quadratilla_n	???
quadratum	n
quadratus_n	m
quadriduum	n
quadriennium	n
quadriga	m
quadrigarius_1	m
quadrigarius_n	m
quadriremis_1	f
quadriuium	n
quadrupedans_1	*
quadrupes_1	*
quadruplator	m
quadruplum	???
quaesitio	f
quaesitor	m
quaesitum	n
quaestio	f
quaestiuncula	f
quaestor	m
quaestorium	n
quaestorius_1	*
quaestuaria	f
quaestura	f
quaestus	m
qualitas	f
qualum	???
qualus	???
quantitas	f
quarinus_n	4
quartadecimani	m
quartana	f
quartani	???
quartarius	*
quartilla_n	???
quasillum	???
quasillus	???
quassatio	f
quassilaria	2
quassus_1	*
quercens_n	m
quercus	f
querela	f
querimonia	f
querquetulanus_n	???
querquetum	n
questus	m
quies	f
quietum	???
quietus_n	m
quinctius_n	???
quincunx	m
quindecimuiri	3
quinquagesima	f
quinquatria	???
quinquatrus_n	f
quinquennium	n
quinqueremis_1	*
quinqueuir	m
quinqueuiratus	m
quintadecimani	???
quintani	*
quinta_n	f
quintianus_n	m
quintia_n	2
quintilianus_n	*
quintilia_n	???
quintilis_n	2
quintilius_n	*
quintilla_n	???
quintius_n	*
quintus_n	*
quirinalis_n	2
quirinius_n	m
quirinus_n	*
quiris_n	m
quiritatus	m
quirites_n	m
quisquilia	n
quisquiliae	f
r	2
rabies	f
rabirius_n	*
rabocentus_n	m
racemus	m
racilius_n	*
radamistus_n	m
radius	*
radix	f
raecius_n	m
raeda	f
raedarius_1	*
raetia_n	f
raeti_n	*
ramale	n
ramenta	f
ramentum	n
ramex	m
ramnes_n	m
ramulus	m
ramus	m
rana	f
rapa	f
rapacida	m
rapacitas	f
raphanus	???
rapiditas	f
rapina_1	f
rapina_2	f
rapo_n	m
raptor	m
raptum	n
raptus	m
rapulum	n
rapum	n
raritas	f
raster	m
rastri	m
rastrum	n
ratio	f
ratiocinator	m
ratis	f
ratiuncula	f
rauenna_n	f
rauidus_n	m
rauis	f
rauola_n	m
rauraci_n	*
rea	f
reatini_n	3
rebellatio	f
rebellio	f
rebilus_n	m
recensio	
receptaculum	n
receptio	f
receptor	m
receptrix	f
receptum	n
receptus_1	m
receptus_n	m
recessus_1	m
recitatio	f
recitator	m
reclamatio	f
recognitio	f
reconciliatio	f
recordatio	f
rectina_n	???
rector	m
rectrix	f
rectum	n
recula	f
recuperatio	f
recuperator	m
recursus	m
recusatio	f
redemptio	f
redemptor	m
redimiculum	n
reditio	f
reditus	m
rediuia	???
redones_n	2
reductor	m
refectio	f
reformatio	f
reformator	m
refrenatio	f
refrigeratio	f
refugium	n
refugus_1	*
refutatus	m
regens	m
regia	f
regia_n	f
regilla	f
regimen	n
regina	f
regina_n	f
regini_n	3
reginus_n	*
regio	f
regium_n	n
regius_n	*
regnator	m
regnatrix	f
regnum	n
regressus	m
regula	f
regulus	m
regulus_n	m
reiectio	f
relatio	f
relatus	m
relegatio	f
relictio	f
religatio	f
religio	f
reliqua	n
reliqui	masculin
reliquiae	f
reliquum	n
remansio	f
remedium	n
remeligo	f
remex	m
remigium	n
remissio	f
remi_n	*
remmius_n	*
remota	f
remulcum	n
remulus_n	m
remuneratio	f
remuria_n	???
remus	m
remus_n	m
renes	???
renuntiatio	f
renutus	m
repagula	n
repastinatio	f
repentinus_n	m
repercussus	m
repertor	m
repertum	n
repetentia	f
repetitio	f
repetitor	m
repetundae	???
repositorium	n
repostor	m
repotia	f
reprehensio	f
reprehensor	m
repressor	m
repromissio	f
repudiatio	f
repudium	n
repugnantia	f
repulsa	f
repulsus_1	m
reputatio	f
requies	f
requies	f
res	f
rescriptum	n
resina	f
respectus	m
respiratio	f
responsio	f
responsum	n
responsus	m
respublica	f
resticula	f
restipulatio	f
restis	f
restitutio	f
restitutor	m
restitutus_n	*
retardatio	f
rete	n
reticentia	f
reticulum	???
reticulus	???
retinaculum	n
retinentia	f
retractatio	f
retrices	???
reudigni_n	*
reuerentia	f
reuerentia_n	f
reuersio	f
reuocamen	n
reuocatio	f
reus	m
rex	m
rex_n	m
rhacotis_n	???
rhadamanthus_n	m
rhaebus_n	m
rhamnes_n	???
rhascypolis_n	m
rhea_n	f
rheda	f
rheno	m
rhenus_n	m
rhescuporis_n	???
rhesus_n	m
rhetor	m
rhetorica	2
rhidagnus_n	4
rhinoceros	m
rhinocolura_n	f
rhipeus_n	???
rhodanus_n	m
rhodia_n	2
rhodienses_n	???
rhodii_n	3
rhodus_n	f
rhoeteum_n	n
rhoetus_n	m
rhombos	???
rhombus	m
rhosaces_n	m
rhoxolani_n	???
rica	f
ricinus	*
rictum	n
rictus	m
ridica	f
ridicularia	???
ridiculum	???
ridiculus_1	*
rigida	2
rigodulum_n	n
rigor	m
rima	f
ripa	f
ripaei_n	*
risor	m
risus	m
ritus	m
riualis_1	*
riuulus	m
riuus	m
rixa	f
robigo	f
robigo_n	f
robur	m
robustus_n	*
rogatio	f
rogatiuncula	f
rogator	m
rogatus	*
rogitatio	f
rogus	m
romani_n	3
romanus_n	*
roma_n	f
romilius_n	*
romulidae_n	m
romulius_n	*
romulus_n	*
ros	
rosa	f
rosarium	n
roscius_n	*
rosetum	n
rosianus_n	m
rosius_n	m
rostrum	n
ros_n	
rota	f
roucillus_n	m
rubellius_n	*
rubeta	f
rubetum	n
rubicola	2
rubico_n	m
rubi_n	m
rubor	m
rubrenus_n	m
rubrica	f
rubrius_n	*
rubus	m
ructus	m
rudens	*
rudicula	f
rudimentum	n
rudis_1	*
rudus	n
rufa_n	f
rufilla_n	???
rufillus_n	*
rufinus_n	*
rufio_n	m
rufrae_n	f
rufrium_n	???
rufrius_n	m
rufulus_n	*
rufus_n	*
ruga	f
rugii_n	???
ruina	f
rullus_n	*
rumor	m
rumor_n	m
rumusculus	m
rupes	f
rupilius_n	*
ruptor	m
ruricola	f
rus	m
ruscino_n	f
ruscum	n
ruscus	m
ruso_n	m
ruspina_n	f
rustianus_n	4
rusticanus_1	*
rusticatio	f
rusticitas	f
rusticulus_1	*
rusticus_1	m
rusticus_n	m
ruta	f
rutabulum	n
ruteni_n	*
rutila_n	f
rutilia_n	???
rutilius_n	*
rutilus_n	*
rutrum	n
rutuba_n	m
rutuli_n	*
rutupinus_n	masculin
sabaea_n	???
sabaei_n	*
sabarcae_n	m
sabbatum	n
sabbatum_n	n
sabelli_n	m
sabinae_n	f
sabina_n	f
sabini_n	*
sabinum_n	???
sabinus_n	m
sabis_n	m
sabrina_n	f
sabulum	n
saburra	m
saburra_n	m
sacae_n	f
saccellus	m
sacculus	m
saccus	m
sacellum	n
sacerdos	2
sacerdos_n	2
sacerdotium	n
sacramentum	n
sacrarium	n
sacrata_n	???
sacratiuir_n	m
sacrator_n	m
sacricola	m
sacrificium	n
sacrilegium	n
sacrilegus_1	*
sacrouir_n	m
sacrum	n
sadala_n	m
saeculum	n
saenius_n	m
saepes	???
saepia	f
saepta	n
saeptum	n
saeta	f
saetiger_1	*
saeuinus_n	4
saeuitia	f
saeuitudo	f
safinius_n	4
sagacitas	f
sagana_n	f
sagaris_n	f
sagaritis_n	f
saga_1	f
saga_2	f
sagina	f
sagitta	f
sagittarius_1	m
sagitta_n	f
sagulum	n
sagum	n
saguntini	???
saguntini_n	???
saguntum_n	???
sal	m
salamandra	f
salaminii_n	???
salamis_n	f
salapini_n	???
salaputium	n
salarium	n
salarius_n	*
salebra	f
saleius_n	m
salentini_n	*
salernum_n	n
saliatus	m
salictarius_1	*
salictum	n
salienus_n	m
salii	m
salii_n	m
salillum	n
salinae	f
salinator	m
salinator_n	m
salinum	n
saliua	f
saliunca	f
salius_n	*
salix	m
sallustius_n	*
salmacides_n	m
salmonis_n	f
salonae_n	f
salona_n	f
salonina_n	???
saloninus_n	*
salpa	f
salsamentum	n
salsum	n
salsum_n	n
salsura	f
saltatio	f
saltator	m
saltatrix	f
saltatus	m
saltius_n	m
saltuarius	*
saltus_1	m
saltus_2	m
salubritas	f
saluianus_n	m
saluidienus_n	m
saluius_n	m
salum	n
salus	f
salus_n	f
salutatio	f
salutator	m
salutatrix	f
saluus_n	*
samaritae_n	m
samarobriua_n	f
samaxus_n	m
sambuca	f
sambus_n	m
samiarius_n	m
samii_n	3
samiramis_n	f
samius_n	*
samnis_n	2
samnites_n	2
samnium_n	n
samothraces_n	???
samothracia_n	f
samus_n	f
sancia_n	???
sanctimonia	f
sanctio	f
sanctitas	f
sanctor	m
sanctum	???
sanctus_n	m
sancus_n	m
sandapila	f
sandyx	2
sangarius_n	*
sanga_n	m
sanguen	???
sanguis	m
sangunculus	m
sangunnius_n	4
sanies	f
sanitas	f
sanna	f
sanquinius_n	m
santones_n	2
santoni_n	*
sapa	f
sapaei_n	*
saperda	m
sapiens_1	*
sapiens_n	*
sapientia	f
sapor	m
sarcina	f
sarcinator	m
sarcinula	f
sarcophagus	m
sarculum	n
sardanapallus_n	???
sardanapalus_n	m
sardes_n	f
sardiani_n	???
sardinia_n	f
sardi_n	*
sardonyx	2
sargus	m
sariolenus_n	???
sarisa	f
sarisophorus	m
sarmatae_n	f
sarmata_n	???
sarmatia_n	f
sarmentum	n
sarmentus_n	m
sarnus_n	m
sarpedon_n	m
sarracum	n
sarrastes_n	2
sartago	f
sartor_2	m
sartura	f
saserna_n	m
sason_n	???
sassia_n	f
sassura_n	2
sata	n
satelles	m
satellius_n	m
satias	f
satibarzanes_n	m
saticulus_n	*
satietas	f
satio_1	
satisdatio	f
satisfactio	f
sator	m
sator_n	m
satrachus_n	???
satrapea	???
satrapes	m
satrapes	m
satria_n	2
satrius_n	*
sattia_n	2
satura	f
satura_n	f
saturitas	f
saturitas_n	f
saturius_n	m
saturnalia_n	???
saturnia_n	f
saturninus_n	m
saturnus_n	m
satus_1	m
satyra_n	???
satyrion	n
satyrus	m
satyrus_n	m
sauciatio	f
saufeia_n	f
saufeius_n	*
sauillum	n
sauium	n
saurea_n	f
sauromatae_n	m
sauromates_n	2
saxatilis	*
saxa_n	n
saxetum	n
saxum	n
saxum_n	n
scabellum	n
scabies	f
scabitudo	f
scaeae_n	???
scaea_n	f
scaeua_2	m
scaeua_n	m
scaeuinus_n	???
scaeuola_n	m
scalae	f
scaldis_n	???
scalmus	m
scalpellum	n
scalprum	???
scalptor	m
scamander_n	m
scammonium	n
scamnum	n
scandilius_n	*
scandula	f
scantia_n	f
scapha	f
scaphium	n
scaptensula_n	???
scapula	m
scapula_n	m
scapus	m
scarus	m
scatebra	f
scaurus_n	m
scazon	m
scelerati	masculin
scelus	n
scelus_n	n
scena	f
scenicus_1	masculin
sceptrum	n
sceptuchus	m
scetanius_n	4
schedium	n
schema	n
scherini_n	*
schoenus	f
schola	m
scholasticus_1	m
schola_n	m
sciathus_n	f
scientia	f
scilla	f
scintilla	f
scintilla_n	f
scipiadas_n	m
scipiades_n	m
scipio	m
scipio_n	m
sciron_n	m
scirpea	n
scirpiculus_1	*
scirtus_n	4
sciscitatio	f
scissa_n	???
scissor	m
scissura	f
scitum	n
scobis	???
scomber	???
scopae	f
scopio	m
scopula	f
scopulus	m
scordalia	f
scordalus	m
scorpio	m
scorpius	m
scortator	m
scortillum	n
scortum	n
scortum_n	n
scriba	m
scribilita	f
scriblita	???
scribonianus_n	???
scribonia_n	???
scribonius_n	*
scrinium	n
scripta	f
scriptio	f
scriptor	m
scriptulum	n
scriptum	n
scriptura	f
scripulum	n
scrobis	???
scrofa	m
scrofipascus	m
scrupulus	m
scrupus	m
scruta	n
scrutatio	f
sculponeae	f
scurra	f
scurrilitas	f
scutarius	*
scutica	f
scutigerulus	m
scutra	f
scutriscum	n
scutula	f
scutulata	???
scutum	n
scydrothemis_n	???
scylaceum_n	???
scylax_n	???
scylla_n	f
scymnus	m
scyphus	m
scyrus_n	m
scythae_n	m
scytha_n	2
scythia_n	f
sebagnini_n	3
sebethis_n	f
sebum	n
secessio	f
secessus	m
secretum	n
secta	f
sectator	m
sectio	f
sector_1	m
sectura	f
secubitus	m
secundae	f
secundani	???
secundus_n	*
securis	f
securitas	f
secus_1	m
secutor	m
sedamen	n
sedatio	f
sedes	f
sedile	n
seditio	f
sedochezi_n	???
seductio	f
sedulitas	f
sedullus_n	4
seduni_n	*
sedusii_n	*
seges	f
segestani_n	???
segesta_n	f
segestes_n	m
segimerus_n	m
segimundus_n	m
segmentum	n
segnitia	f
segnities	f
segni_n	*
segontiaci_n	*
segouax_n	m
segouia_n	f
segusiaui_n	*
seianus_n	*
seius_n	m
seleucea_n	???
seleucenses_n	3
seleucia_n	f
seleucus_n	m
selibra	f
sella	f
sellarius	*
sellisternium	n
sellula	f
semele_n	f
sementis	f
semen_1	n
semicaper	m
semicinctium	n
semidea	f
semifunium	n
semihomo	m
semihora	f
seminarium	n
seminium	n
semipes	m
semiramis_n	f
semis_1	m
semis_1	m
semita	f
semiuir	m
semnones_n	2
semodius	*
semo_n	m
sempronia_n	f
sempronius_n	*
semuncia	f
semurium_n	???
senator	m
senatus	m
seneca_n	m
senecio_n	m
senecta	f
senectus_1	f
senectus_n	f
senex_1	m
senienses_n	???
senio	m
senior	m
senium	n
senones_n	2
seno_n	
sensus	m
sententia	f
sententiola	f
senticetum	n
sentina	f
sentis	f
sentius_n	*
separatio	f
sepes	m
sepiola	f
seplasia_n	f
seplasium	n
september_n	???
septemuir	???
septemuiralis_1	*
septemuiratus	m
septemuiri	m
septentrio	m
septentrionalia	???
septentrio_n	m
septicius_n	*
septimani	???
septimillus_n	???
septiminus_n	4
septimius_n	*
sepulcretum	n
sepulcrum	n
sepultura	f
sequana_n	f
sequani_n	*
sequester_1	m
sequester_1	m
sequester_1	m
serapa_n	2
serapion_n	m
serapis_n	m
sera_1	f
serenitas	f
serenum	n
serenus_n	*
serestus_n	m
seres_n	m
sergestus_n	m
sergiolus_n	???
sergius_n	*
seria	f
serica	f
series	f
seriola	f
seriphus_n	f
serisapia	f
serium	n
sermo	f
sermo_n	f
sermunculus	m
serpens	m
serpyllum	???
serra	f
serrana_n	2
serranus_n	m
serrarius	*
serrula	f
serta	f
sertius_n	neutre
sertorius_n	m
sertum	n
serua	f
seruaeus_n	???
seruatio	f
seruator	m
seruianus_n	*
seruiens	m
seruilia_n	???
seruilius_n	*
seruitium	n
seruitus	m
seruitus_n	m
seruius_n	m
serum_1	n
serum_2	n
seruulus	???
seruus_1	m
sesama	f
sesamum	n
sescentoplagus_n	*
sesosis_n	???
sesqueopus	4
sesquihora	f
sesquilibra	f
sesquimodius	m
sesquipes	m
sesquiplaga	f
sessio	f
sessor	m
sessorium	n
sestertium	n
sestertius_1	*
sestius_n	*
sestus_n	f
setinum_n	n
seuera	???
seueri	???
seueritas	f
seueritudo	f
seuerus_n	m
seuir	m
seuiratus	m
sexennium	n
sextadecimani	m
sextans	m
sextarius	m
sextia_n	???
sextilia_n	???
sextilis_n	*
sextilius_n	*
sextius_n	*
sextula	f
sextus_n	m
sexus	m
sibilum	n
sibilus_1	*
sibi_n	*
sibulates_n	3
sibylla_n	f
sibyrtius_n	m
sica	f
sicania_n	f
sicani_n	*
sicarius	m
sicca_n	2
siccenses_n	???
siccitas	f
siccum	n
sicilia_n	f
sicilimentum	n
sicinius_n	*
sicoris_n	m
sicula	f
siculi_n	3
sicyonia_n	f
sicyon_n	*
sidicini_n	???
sidonii_n	3
sidon_n	f
sido_n	
sidus	n
sigeum_n	n
sigillaria	n
sigillum	n
signator	m
signifer_1	*
significatio	f
signum	n
silana_n	f
silanion_n	???
silanus	*
silanus_n	*
silarus_n	m
sila_n	f
silena_n	???
silentium	n
silenus_n	m
siler	m
silex	m
silia_n	2
siligo	f
siliqua	f
silius_n	m
sillius_n	???
silo_n	m
silphium	n
silua	f
siluanus_n	*
siluia_n	f
siluicola	2
siluicultrix	f
siluius_n	*
silures_n	m
silurus	m
silus_n	m
simia	f
similago	f
similitudo	f
simius	m
simois_n	m
simonides_n	m
simon_n	m
simo_n	m
simplex_n	*
simplicitas	f
simpuuium	n
simui_n	3
simulacrum	n
simulans_n	???
simulatio	f
simulator	m
simultas	f
sincaius_n	4
sinceritas	f
sinciput	n
singulares_n	m
singula_2	f
singultus	m
sinisteritas	f
sinistra_1	f
sinistrum	n
sinis_n	???
sinon_n	m
sinopa_n	???
sinopenses_n	3
sinope_n	f
sinuessa_n	???
sinus	m
siparium	n
siphnus_n	f
sipho	???
siphunculus	m
sipylus_n	m
siraci_n	*
siren_n	f
sirius_n	*
sirmio_n	f
sirpicium	n
sirpiculus	???
sirpicus_n	m
sirus	m
sisapo_n	f
sisenes_n	m
sisenna_n	???
siser	n
sisigambis_n	f
sisimithres_n	3
sisocostus_n	4
sistrum	n
sisymbrium	n
sisyphus_n	m
sitella	f
sithones_n	m
sithonii_n	???
siticen	m
sitis	f
sittacene_n	f
sittius_n	m
situla	f
situlus	m
situs_1	m
smaragdus	m
smaris	f
smyrna	f
smyrnaei_n	???
smyrna_n	f
smyrnion	n
sobrietas	f
sobrina	f
sobrinus	m
socculus	m
soccus	m
socer	???
socia	f
socialitas	f
sociennus	m
societas	f
socius_1	*
socordia	f
socrates_n	m
socratici_n	???
socrus	???
sodalicium	n
sodalis_1	*
sodalitas	f
sogdiani_n	*
sohaemus_n	m
sol	m
solaciolum	n
solacium	n
solamen	n
solarium_2	n
solator	m
soldurii	m
solea	f
solearius	*
solenne	???
solidum_1	n
solimus_n	???
solitudo	f
solitum	???
solium	n
soli_n	m
sollemne	n
sollers_n	*
sollertia	f
sollicitatio	f
sollicitudo	f
soloecismus	m
soloni_n	masculin
solon_n	m
solstitium	n
solum_1	n
soluntini_n	*
solutio	f
solutum	n
solymi_n	*
sol_n	m
somnium	n
somnium_n	n
somnus	m
somnus_n	m
sonipes_1	*
sonitus	m
sonor	m
sons_1	m
sonus	m
sonus	m
sonus	m
sopater_n	m
sophia	f
sophisma	n
sophistes	???
sophites_n	3
sophocles_n	m
sophroniscus_n	m
sopitio	f
sopolis_n	m
sopor	m
sopor_n	m
soracte_n	n
soranus_n	*
sora_n	f
sorbitio	f
sorbum	n
sorbus	f
sordes	???
soricaria_n	???
soror	m
sororicida	m
soror_n	m
sorrentum_n	???
sors	f
sortientes_n	???
sortitio	f
sortitor	m
sortitus	m
sosianus_n	*
sosia_n	m
sosibius_n	m
sosii_n	masculin
sosippus_n	m
sositheus_n	m
sosius_n	*
sospita_n	f
sostratus_n	m
sotericus_n	???
soteris_n	f
sotiates_n	???
sotion_n	m
soza_n	f
spadix	m
spado	m
spartacus_n	m
spartani_n	???
sparta_n	f
spartum	???
sparulus	m
sparus	m
spatalocinaedus	m
spatha	f
spatiator	m
spatium	n
species	f
specillum	n
specimen	n
spectaculum	n
spectans	n
spectatio	f
spectator	m
spectatrix	f
spectio	f
speculare	neutre
specularia	n
specularia	n
specularia	n
speculator	m
specula_1	f
specula_2	f
speculum	n
specum	n
specus	*
spelaeum	n
spelunca	f
spelunca_n	f
speratum	n
spes	f
spes_n	f
speusippus_n	m
sphaera	f
sphaeristerium	n
sphaerita	m
sphinx_n	f
spica	f
spiculum	n
spicum	n
spina	m
spinetum	n
spinther_n	m
spintria	f
spinus	f
spira	f
spiraculum	n
spiramentum	n
spiritus	m
spissamentum	n
spitamenes_n	m
splen	m
splendor	m
splenium	n
spoliarium	n
spoliatio	f
spoliator	m
spoliatrix	f
spolium	n
sponda	f
spondeus	m
spondylus	???
spongia	m
spons	f
sponsa	f
sponsalia	n
sponsalia	n
sponsalia	n
sponsio	f
sponsiuncula	f
sponsor	m
sponsum	n
sponsus_1	m
sponsus_n	m
sporta	f
sportella	f
sportula	f
spuma	f
spurcitia	f
spurcities	f
spurinna_n	m
spurius_n	m
sputum	n
sputus	m
squalor	m
squama	f
squilla	f
squillus_n	4
staberius_n	m
stabiae_n	f
stabilimentum	n
stabilitas	f
stabilitor	m
stabularius	*
stabulum	n
stacta	2
stadium	n
stagnum_1	n
staienus_n	???
staius_n	m
stalagmus_n	???
stamen	n
staphyla_n	2
stasanor_n	m
statera	f
staticulus	m
statilia_n	???
statilius_n	*
statio	f
statira_n	2
statiua	n
statius_n	*
stator	m
stator_n	m
statua	f
statuarius_1	*
statumen	n
statunculum	n
statura	m
status_1	m
stega	f
stela	???
stella	m
stella_n	m
stellio	m
stemma	n
sterculinum	n
stercus	n
sterilicula	f
sterilitas	f
sternumentum	n
sternutamentum	n
steropes_n	m
sterquilinum	???
stertinius_n	*
stesichorus_n	m
stheneboea_n	???
sthenelus_n	m
sthenius_n	m
stibadium	n
stichus_n	m
stigma	n
stigma	n
stigmatias	m
stilbon_n	m
stilla	f
stillarium	n
stillicidium	n
stilonius_n	m
stilus	m
stimulatio	f
stimula_n	f
stimulus	m
stipatio	f
stipator	m
stipendiarius_1	*
stipendium	n
stipes	m
stips	f
stipula	f
stipulatio	f
stiria	f
stirps	???
stiua	f
stlatarius	4
stloga_n	2
stloppus	m
stoicida_n	m
stoici_n	m
stola	m
stolata	2
stomachicus	*
stomachus	m
storea	f
strabo	m
strabo_n	m
strages	f
stragula	f
stragulum	n
stramen	n
stramentum	n
stranguria	f
strategus	m
stratippocles_n	???
stratocles_n	m
stratonica_n	???
stratonicenses_n	???
stratonicis_n	f
straton_n	???
stratum	n
stratus_n	2
strepitus	m
strictor	m
strictura	f
stridor	m
striga_2	f
strigilis	f
strigor	m
stringor	
strix	f
strobilus_n	m
strolus_n	4
stropha	f
strophades_n	f
strophiarius	m
strophium	n
strophius_n	???
structor	m
structura	f
strues	f
struma	m
struthocamelus	m
strymonis_n	f
strymonius_n	*
strymon_n	m
studium	n
stulti	???
stultitia	f
stulti_n	???
stupiditas	f
stupor	m
stuppa	f
stuprator	m
stuprum	n
stymphala_n	n
stymphalidae_n	f
stymphalis_n	f
styx_n	f
suada_n	f
suadela_n	f
suardones_n	2
suasio	f
suasor	m
suasoria	f
suasus	m
suauiolum	???
suauisauiatio_n	f
suauitas	f
suauitudo	f
suauium	???
subbasilicanus	m
subductio	f
suber	m
subiector	m
subiectum	n
subiectus_1	m
subigitatio	f
subitum	???
sublaqueum_n	n
sublica	f
subligaculum	n
subligar	n
sublime_1	???
sublimitas	f
subministrator	m
submissio	f
subnimium	
subnuba	f
suboles	f
subortus	m
subrius_n	m
subscriptio	f
subscriptor	m
subscus	f
subsellium	n
subsessor	m
subsidium	n
subsortitio	f
substantia	f
substructio	f
subtemen	n
subtilitas	f
subucula	f
subuectio	f
subuectus	m
subuersor	m
subula	f
subulcus	m
suburanus_n	*
subura_n	f
suburbani	m
suburbanitas	f
suburbanum	n
suburbium	n
successio	f
successor	m
successus	m
succidia	f
sucinum	n
sucro_n	m
sucula	f
sucus	m
sudarium	n
sudatio	f
sudatorium	n
sudes	m
sudis	m
sudor	m
sudracae_n	???
sudum	???
sueba_n	2
suebia_n	???
suebi_n	*
suedius_n	???
suessa_n	f
suessiones_n	2
suetonius_n	m
suettius_n	4
sueui_n	*
sufes	m
suffenus_n	???
sufficius_n	4
suffimen	n
sufflamen	n
suffocatio	f
suffossio	f
suffragatio	f
suffragator	m
suffragium	n
suffugium	n
suffusio	f
sugambri_n	*
suggestum	n
suggestus	m
sugillatio	???
suillius_n	m
suionae_n	2
suiones_n	m
sulcitani_n	???
sulcus	m
sulfur	???
sulgius_n	4
sulmonenses_n	???
sulmo_n	m
sulpicia_n	f
sulpicius_n	*
sumen	n
summa	f
summanus_n	m
summarium	n
summatus	*
summula	f
summum_1	n
sumptio	f
sumptus_1	m
sumptus_2	m
sunium_n	n
sunuci_n	*
suouetaurilia	n
supellecticarius	*
supellex	f
superator	m
superbia	f
superbus_1	*
superbus_n	*
supercilium	n
superi	m
superior	*
superiora	neutre
supernum	neutre
superstitio	f
superuacuum	neutre
superuentus	m
superum	neutre
supparum	n
suppetiae	f
supplementum	n
supplex_1	*
supplicatio	f
supplicium	n
supplosio	f
suppositio	f
suppressio	f
suppuratio	f
supremum_1	???
sura	m
sura_n	m
surculus	???
surena_n	m
surrentinum_n	neutre
surrentum_n	n
surus_n	*
sus	m
susagus_n	m
susa_n	n
susceptio	f
susiani_n	???
suspectus_1	*
suspendium	n
suspensum	n
suspensura	f
suspicio_1	f
suspirium	n
susurrus	*
sutela	f
suthul_n	???
sutor	m
sutrinum	n
sutrium_n	n
sutura	f
suum	n
sybaris_n	f
sybaritae_n	2
sybilla_n	2
sybylla_n	2
sycambri_n	*
sychaeus_n	*
sycophanta	m
sycophantia	f
sygambra_n	???
syllaba	f
sylla_n	m
syllogismus	m
symbola	f
symbolus	m
symmachus_n	m
symphonia	f
symphoniacus_1	*
symplegas_n	f
symposium_n	n
synephebi_n	???
syngrapha	2
syngraphus	m
synoecium	n
syphax_n	m
syracusae_n	f
syracusani_n	???
syria_n	f
syrii_n	???
syri_n	*
syrma	f
syrophoenix_n	2
syrtes_n	???
syrtis	???
syrtis_n	???
syrus_n	f
tabae_n	f
tabella	f
tabellarius_1	*
taberna	f
tabernaculum	n
tabernarius_1	*
tabes	f
tabes_n	f
tabraca_n	f
tabula	f
tabularium	n
tabularius_1	*
tabulatio	f
tabulatum	n
tabum	n
taburnus_n	m
tacfarinas_n	m
tacitum	???
taciturnitas	f
tacitus_n	m
tactio	f
tactus	m
tadius_n	m
taeda	f
taedium	n
taenaris_n	f
taenarus_n	2
taenia	f
tagus_n	m
talaria	n
talassius_n	m
talaus_n	m
talea	f
talentum	n
talio	
tallus_n	4
talpa	f
talthybius_n	m
talus	m
tamesis_n	m
tamesis_n	m
tampilus_n	4
tampius_n	4
tanager_n	m
tanagra_n	f
tanais_n	m
tanaitis_n	f
tanaquil_n	f
tanaus_n	m
tanfana_n	f
tantalides_n	m
tantalides_n	m
tantalis_n	f
tantalis_n	f
tantalus_n	4
tanusius_n	m
tapanta	2
tapes	???
tapetum	n
tappo_n	???
tapsitani_n	3
tapuri_n	???
tarbelli_n	*
tarchon_n	m
tarcondarius_n	4
tarditas	f
tarentini_n	???
tarentum_n	n
tarius_n	*
tarpa_n	m
tarpeia_n	f
tarpeius_n	*
tarpezita	m
tarquinius_n	*
tarquitius_n	m
tarquitus_n	???
tarracina_n	f
tarracinenses_n	???
tarraconenses	3
tarraco_n	m
tarsa_n	m
tarsus_n	f
tartara_n	n
tartarus_n	1
tartessii_n	masculin
tarula_n	m
tarusates_n	2
tasgetius_n	m
tatius_n	*
taunus_n	m
taurea	m
taurea_n	m
taurinites_n	3
taurini_n	*
tauris_n	f
tauri_n	*
tauromenitani_n	???
tauromenum_n	???
tauron_n	???
taurulus	m
taurus	m
taurus_n	m
taxatio	f
taxiles_n	m
taximagulus_n	m
taxus	f
taygetus_n	m
teanum_n	n
techna	f
tecmessa_n	f
tecta_n	2
tector	m
tectorium	n
tectosages_n	m
tectum	???
tedia_n	2
tegeatae_n	???
tegea_n	f
teges	f
tegimen	n
tegimentum	n
tegula	f
teia_n	f
tela	f
telamonius_n	*
teleboae_n	m
teleboi_n	3
telegonus_n	m
telemachus_n	m
telemus_n	???
telephus_n	m
telesinus_n	*
telesphorus_n	m
telestis_n	f
teleus_n	4
telinum	n
tellus	f
tellus_n	f
telum	n
temeritas	f
temesa_n	f
temetum	n
temnii_n	???
temnites_n	m
temnus_n	2
temo	m
temperamentum	n
temperantia	f
temperatio	f
temperator	m
temperatura	f
temperies	f
tempestas	f
tempestas_n	f
tempestiuitas	f
templum	n
temptator	m
tempus_1	n
tempus_2	n
temulentus_1	*
tencteri_n	*
tenctheri_n	???
tendicula	f
tenebrae	f
tenedii_n	???
tenedus_n	f
tenerum	neutre
tenes_n	m
tenii_n	*
tenor	m
tensa	f
tentamentum	n
tentigo	f
tentoriolum	n
tentorium	n
tentum	n
tentyra_n	n
tenue	???
tenuitas	f
tenus_1	f
tepor	m
terebinthus	???
terebra	f
terentia_n	???
terentius_n	*
teretina_n	2
tereus_n	m
tergestini_n	???
tergiuersatio	f
tergum	n
tergus	n
terioltes_n	m
termentum	n
termes	f
termestini_n	???
terminalia	n
terminalia_n	n
terminatio	f
terminus	m
terminus_n	m
terpolius_n	4
terra	f
terrasidius_n	m
terra_n	f
terrena	2
terreni	masculin
terrenum	???
terrigena	m
territorium	n
terror	m
tertiadecimani	m
tertiana	???
tertianus_1	*
tertiarius_1	*
tertia_n	f
tertullinus_n	???
tertullus_n	m
teruncius	m
tesca	n
tessela	2
tessera	f
tesserarius_1	*
tesserula	f
testa	f
testamentarius_1	*
testamentum	n
testiculus	m
testificatio	f
testimonium	n
testis_1	2
testis_2	2
testu	n
testudo	f
testum	n
tethys_n	???
tetrarches	???
tetrarches_n	???
tetrarchia	f
tetrastylon	???
tetrica_n	???
tettius_n	m
teucer_n	m
teucria_n	f
teucri_n	3
teuthras_n	m
teutomatus_n	m
teutones_n	2
teutoni_n	*
textile	???
textor	m
textrinum	n
textrix	f
textum	n
textura	f
textus	m
thabena_n	f
thabenenses_n	???
thais_n	f
thalamus	m
thala_n	f
thalestris_n	f
thales_n	m
thaliarchus_n	???
thalia_n	f
thallus_n	m
thamyras_n	m
thamyrus_n	4
thapsacus_n	f
thapsitani_n	*
thapsus_n	2
tharsimachus_n	4
thasus_n	f
theaetetus_n	m
theatrum	n
thebae_n	f
thebaicae	f√©minin
thebais_n	f
thebani_n	???
theca	f
themiscyra_n	f
themison_n	m
themistagoras_n	???
themista_n	f
themistocles_n	m
themis_n	f
theodorus_n	*
theodosius_n	*
theodotus_n	*
theomnastus_n	m
theon_n	m
theophanes_n	m
theophanes_n	m
theophilus_n	*
theophrastus_n	m
theopompus_n	m
theoractus_n	m
theotimus_n	m
therapontigonus_n	m
thermae	f
thermitani_n	???
thermodon_n	m
thermopolium_n	n
thermopylae_n	f
thermus_n	m
theron_n	m
thersilochus_n	m
thersippus_n	4
thersites_n	m
thesaurum	???
thesaurus	???
theseis_n	f
theseus_n	*
thesidae_n	2
thespiades_n	m
thespiae_n	f
thespienses_n	???
thespis_n	m
thesprotus_n	m
thessala_n	2
thessalia_n	f
thessali_n	3
thessalonica_n	f
thessalonicenses_n	???
thessalus_n	m
thessandrus_n	???
thestylis_n	???
thesunti_n	3
thetis_n	f
thiasus	m
thia_n	f
thimiamae	2
thirmida_n	???
thoas_n	m
tholus	m
thorax	m
thraca_n	f
thraces_n	m
thracia_n	f
thraecidica_n	???
thraessa_n	f
thraex_n	m
thrasea_n	m
thrasius_n	m
thrasyllus_n	m
threissa_n	???
thronius_n	4
thucidides_n	m
thurii_n	m
thyas	f
thybris_n	???
thyestes_n	m
thyestes_n	m
thyiades	???
thylacista	m
thymbra	f
thymbraeus_n	*
thymbris_n	???
thymum	n
thynia_n	f
thynnus	m
thyoneus_n	*
thyrsis_n	???
thyrsus	m
thysdra_n	???
thysdritani_n	masculin
tiani_n	3
tiara	f
tiberinus_n	*
tiberiolus_n	???
tiberis_n	m
tiberius_n	*
tibia	f
tibicen	m
tibicina	f
tibullus_n	m
tiburnus_n	???
tiburtes_n	???
tiburtinum_n	???
tiburtius_n	???
tiburtus_n	???
tibur_n	n
ticida_n	m
ticinum_n	n
tigellinus_n	m
tigellius_n	m
tigillum	n
tignum	n
tigranes_n	m
tigranes_n	m
tigranocerta_n	f
tigranocerta_n	f
tigris	m
tigris_n	m
tigurini_n	3
tilia	f
tillius_n	m
timaeus_n	m
timagenes_n	m
timarchides_n	m
timarchides_n	m
timarchus_n	m
timauus_n	m
timiditas	f
timocles_n	m
timon_n	m
timor	m
timor_n	m
timotheus_n	m
tinea	f
tinnitus	m
tintinnabulum	n
tiresias_n	m
tiresia_n	???
tiridates_n	m
tiridates_n	m
tiro	m
tirocinium	n
tiro_n	m
tirunculus	m
tirynthius_n	*
tisamenus_n	m
tisidium_n	n
tisiphone_n	f
tissenses_n	???
titan_n	m
tithonia_n	???
tithonus_n	m
titianus_n	*
titidius_n	???
titienses_n	???
tities_n	???
titillatio	f
titinius_n	*
titius_n	*
tittibilicium	n
titubatio	f
titulus	m
titurius_n	*
titus	m
titus_n	m
tityrus_n	m
tityus_n	m
tlepolemus_n	m
tmarus_n	m
tmolites_n	m
tmolus_n	m
tofus	m
toga	f
togata	???
togati	*
togonius_n	???
togula	f
tolbiacum_n	n
tolenum_n	???
tolerantia	f
tolosates_n	???
tolosa_n	f
tolumnius_n	m
tomaculum	n
tomentum	n
tomyris_n	f
tonans_n	m
tongilius_n	m
tonitrus	???
tonitruum	???
tonsa_1	f
tonsor	m
tonstrina	f
tonstrinum	n
tonstrinus	masculin
tonsura	f
tonsus	m
topiarius	*
toral	???
toranius_n	m
torcular	n
torcularium	n
torculum	n
toreuma	n
torius_n	neutre
tormentum	n
tormina	n
tornus	m
torpedo	f
torpor	m
torquata_n	2
torquatus_n	m
torquis	???
torrens_1	???
torris	m
tortor	m
tortus	m
toruitas	f
torulus	m
torus	*
totum	???
toxicum	n
trabea	m
trabecula	f
trabs	???
trachalus_n	m
tracta	f
tractatio	f
tractator	m
tractatus	m
tractus	m
traditio	f
traditor	m
traductio	f
tradux	2
tragicomoedia	f
tragicus_1	*
tragoedia	f
tragoedia_n	f
tragoedus	m
tragula	f
tragus	m
traha	f
traianus_n	*
traiectus	m
tralles_n	m
tralliani_n	???
trallis_n	f
trama	f
trames	???
tranquillitas	f
tranquillum	n
tranquillus_n	*
transactor	m
transcursus	m
transenna	f
transfuga	m
transfugium	n
transfusio	f
transgressio	f
transgressus	m
transitio	f
transitus	m
translatio	f
translator	m
translatus	m
transmissio	f
transmissus	m
transpadani_n	???
transpectus	m
transportatio	f
transrhenani_n	m
transtrum	n
transuectio	f
transuersum_1	???
trapes	3
trapetum	???
trapetus	???
trapezita	m
trapezus_n	f
trasimenus_n	m
traulus_n	*
trausius_n	???
trebatius_n	m
trebellenus_n	???
trebellius_n	m
trebius_n	m
trebonius_n	m
trebula_n	f
trechedipnum	n
tremellius_n	m
tremor	m
tremulus_n	m
trepidatio	f
tressis	m
tresuiri	???
treueri_n	???
treuiri_n	m
treuir_n	m
triaria_n	???
triarius_1	m
triarius_n	m
triballi_n	*
triboci_n	*
tribulum	n
tribulus	m
tribunal	???
tribunatus	m
tribunicius_1	*
tribunus	m
tribus	f
tributum	n
tributus_1	m
tricae	f
trichila	f
triclinia	n
triclinium	n
tridens_1	*
triduum	n
triennium	n
triens	m
trierarchus	m
trieterica	???
trifolium	n
trifur	m
trifurcifer	m
trigemina_n	???
trigon	m
trimalchio_n	???
trimerus_n	???
trimeter_1	???
trinacria_n	f
trinacris_n	f
trinobantes_n	2
trinouantes_n	???
trinundinum	n
triobolus	m
trio_n	m
triphallus_n	m
triptolemus_n	m
tripudium	n
tripus_1	m
triremis_1	*
trisantona_n	2
triscurrium	n
triste_1	???
tristimonia	f
tristimonium	n
tristitia	f
triticum	n
tritonia_n	???
triton_n	m
tritura	f
triuia_n	f
triuicum_n	n
triuium	n
triumphalia	neutre
triumphus	m
triumphus_n	m
triumuir	m
triumuiratus	m
trochlea	f
trochus	???
troes_n	2
troezen_n	f
trogodytae_n	???
trogus_n	m
troiades_n	f
troiani_n	3
troia_n	f
troica_n	2
troilus_n	m
troiugena_n	2
tropaeum	n
tropica	???
trossulus	m
troucillus_n	4
troxoborus_n	4
trucidatio	f
truculentia	f
truculentus_n	m
trudis	f
trulla	m
trulleus	???
truncus_1	*
trutina	f
trygonus	f
tryphaena_n	???
trypherus_n	m
tuba	f
tubantes_n	2
tuber	m
tubero_n	m
tubertus_n	m
tubicen	m
tubilustria_n	???
tubula	f
tubulus_n	m
tubus	m
tuccetum	n
tuccia_n	f
tuccius_n	m
tuder_n	n
tudicius_n	???
tuditanus_n	m
tugio_n	???
tugurium	n
tuisto_n	m
tulingi_n	*
tulla_n	n
tullianum_n	???
tullia_n	???
tullinus_n	???
tullio_n	m
tullius_n	*
tullus_n	m
tumor	???
tumultus	m
tumulus	???
tungri_n	*
tunica	f
tunicula	f
tunnius_n	4
turannius_n	???
turba	f
turbamentum	n
turbator	m
turbellae	???
turben	???
turbo_1	m
turbo_n	m
turda	f
turdetani_n	m
turdus	m
turibulum	n
turius_n	*
turma	f
turnus_n	m
turoni_n	*
turpe_1	???
turpilianus_n	???
turpilius_n	*
turpio_n	m
turpitudo	f
turranius_n	*
turris	f
turselius_n	4
turta_n	2
turtur	m
turturilla	???
turullius_n	m
turunda	f
tus	???
tuscilius_n	???
tusci_n	3
tusculani_n	???
tusculanum_n	???
tusculum	n
tusculum_n	n
tusculus_n	*
tuscus_n	*
tussicula	f
tussis	f
tutamen	n
tutela	f
tutela_n	f
tuticanus_n	*
tutilius_n	???
tutor_1	m
tutor_n	m
tutum	???
tuum	neutre
tycha_n	f
tychius_n	*
tympanum	n
tyndareus_n	m
tyndaridae_n	???
tyndaris_n	???
tyndaritani_n	???
tyndarus_n	???
typhoeus_n	m
tyracinus_n	m
tyrannicida	m
tyrannis	f
tyrannus	m
tyridates_n	3
tyrii_n	???
tyriotes_n	3
tyrrheni_n	*
tyrrhenus_n	???
tyrrhidae_n	m
tyrrhus_n	???
tyrtaeus_n	m
tyrus_n	4
uacalus_n	m
uacalus_n	m
uacatio	f
uacca	m
uaccaei_n	*
uacca_n	m
uaccenses_n	???
uaccinium	n
uaccus_n	m
uacuitas	f
uacuna_n	f
uacuum	n
uada_n	n
uadimonium	n
uadum	n
uadum_n	n
uafritia	f
uaga_n	f
uagellius_n	m
uagina	f
uagitus	m
uagor_1	
uala_n	m
ualens_n	m
ualentia_n	f
ualentini_n	*
ualentinus_n	m
ualentius_n	*
ualeria_n	f
ualerius_n	*
ualerus_n	???
ualetiacus_n	m
ualetudinarium	n
ualetudinarius_1	*
ualetudo	f
ualgius_n	*
uallis	f
uallum	n
uallus_1	m
uallus_2	m
ualua	f
ualuae	f
uana	f
uandilii_n	???
uangiones_n	m
uangio_n	m
uaniloquentia	f
uanitas	f
uanitudo	f
uannius_n	m
uannus	m
uanum	???
uapor	???
uappa	f
uardanes_n	m
uarenus_n	m
uargunteius_n	m
uariantia	f
uaria_n	f
uarietas	f
uarilla_n	f
uarillus_n	???
uarinius_n	m
uarini_n	*
uarisidius_n	m
uarium	neutre
uarius_n	*
uarix	f
uarro_n	m
uarus_n	m
uasa	f
uasarium	n
uascones_n	2
uascularius	*
uasculum	n
uasius_n	4
uastatio	f
uastator	m
uastatrix	f
uastitas	f
uastitudo	f
uasus	m
uas_1	n
uas_2	n
uas_2	n
uates	m
uatia_n	f
uaticanus_n	*
uaticinatio	f
uatillum	n
uatiniani_n	masculin
uatinius_n	*
uauato	m
ubertas	f
uber_1	n
ubii_n	*
ucubis_n	f
uecellinus_n	4
uecordia	f
uectatio	f
uectigal	n
uectis	m
uector_1	m
uectura	f
uedius_n	*
uehes	3
uehiculum	n
uehilius_n	m
ueianius_n	m
ueia_n	f
ueientes_n	2
ueiento_n	m
ueii_n	m
ueiouis_n	m
uelabra_n	2
uelabrum_n	n
uelamen	n
uelamentum	n
uelanda	n
uelanius_n	m
uelarium	n
ueleda_n	f
ueles	m
uelia_n	f
uelienses_n	2
uelinus_n	*
ueliocasses_n	2
ueliocassi_n	???
uelius_n	m
uellauii_n	???
uellaunodunum_n	n
uelleius_n	*
uelleus_n	*
uellicatio	f
uelliocasses_n	3
uellocatus_n	???
uellus	m
uelocitas	f
uelum	n
uena	f
uenabulum	n
uenafrum_n	n
uenales	???
uenalia	neutre
uenalicium	n
uenalicius_1	*
uenans	n
uenatio	f
uenator	m
uenatrix	f
uenatus	*
uenditatio	f
uenditator	m
uenditio	f
uenditor	m
uenditum	???
uenefica	f
ueneficium	n
ueneficus_1	*
uenenum	n
uenerarius_1	*
ueneratio	f
ueneriae	f
uenethi_n	3
uenetia_n	f
ueneti_n	*
uenetus_n	*
uenia	f
uenilia_n	f
uennonius_n	m
uenter	m
uentidius_n	m
uentipo_n	???
uentriculus	m
uentulus	m
uenturum	n
uentus	m
uenuleius_n	*
uenulus_n	???
uenum	???
uenustas	f
uenustas_n	f
uenus_1	f
uenus_n	f
uenutius_n	4
ueprecula	f
uepres	3
uer	n
ueragri_n	*
uerania_n	???
ueraniolus_n	???
ueranius_n	m
ueratrum	n
uerax_n	m
uerbena	f
uerber	n
uerberatus	m
uerbero_1	m
uerbigenus_n	m
uerbiuelitatio	f
uerbum	n
uercassiuellaunus_n	4
uercellae_n	f
uercingetorix_n	m
uerculum	n
uerecundia	f
uerenda	???
uergiliae_n	f
uergilius_n	*
uerginius_n	*
uergobretus	m
uerisimilitudo	f
ueritas	f
ueritas_n	f
ueriuerbium	n
uermiculus	m
uermina	m
uerminatio	f
uermis	m
uerna	f
uernaculus_1	*
uernilitas	f
uernula	m
uernum	n
uerona_n	f
ueronenses_n	???
uerpa	f
uerpus	m
uerres	m
uerres_n	m
uerria_n	f
uerritus_n	m
uerruca	f
uerrucius_n	???
uerrucosus_n	m
uersatio	f
uersiculus	m
uersura	f
uersus_1	
uertebra	f
uertex	m
uertico_n	m
uertigo	f
uertiscus_n	m
uertumnus_n	m
ueru	n
ueruactum	n
uerucloetius_n	m
ueruex	m
ueruina	f
uerulamium_n	n
uerulana_n	???
uerulanus_n	*
uerum_1	n
uerum_2	n
uerus_n	m
uerutum	n
uesaeuus_n	*
uesania	f
uescularius_n	m
ueseris_n	m
uesica	f
uesicula	f
uesontio_n	m
uespasianus_n	m
uesper	m
uesper	m
uesper	m
uespera	f
uesperugo_n	f
uesper_n	m
uesper_n	m
uespillo_n	m
uestalis_1	2
uestalis_n	2
uesta_n	f
uestes	???
uestiarium	n
uestiarius_1	*
uestibulum	n
uesticontubernium	n
uestigator	m
uestigium	n
uestimentum	n
uestinus_n	???
uestis	f
uestitus_1	m
uestricius_n	m
uestrius_n	m
uesulus_n	m
uesuuius_n	m
uetera	n
ueteranus_1	*
ueterarium	n
ueterator	m
uetera_n	n
ueteres	m
ueternus_1	*
uetilius_n	???
uetitum	n
uettidius_n	4
uettius_n	*
uettones_n	2
uettonianus_n	???
uetula	f
uetulus_1	m
ueturius_n	*
uetustas	f
uetus_n	???
uexamen	n
uexatio	f
uexator	m
uexillarius	*
uexillum	n
ufens_n	m
ufentina_n	2
uia	f
uiaticum	n
uiator	m
uia_n	f
uibellius_n	m
uibenna_n	???
uibennius_n	???
uibex	???
uibia_n	f
uibidia_n	???
uibidius_n	*
uibienus_n	m
uibilius_n	m
uibius_n	*
uibo_n	f
uibulenus_n	???
uibullius_n	m
uiburnum	n
uicanus_1	*
uicarius_1	*
uica_n	f
uicesima	f
uicesimanus	*
uicesimarius_1	*
uicetia_n	f
uicetini_n	*
uicia_1	???
uicina	f
uicinia	f
uicinitas	f
uicinum	n
uicinus_1	m
uicis	f
uicissitudo	f
uictima	f
uictius_n	neutre
uictor	m
uictoria	f
uictoriatus	*
uictoria_n	f
uictor_n	m
uictrix_1	*
uictus	m
uicus	m
uicus_n	m
uidua	f
uiduertas	f
uiduitas	f
uidulus	m
uienna_n	f
uiennenses_n	???
uigilantia	f
uigiles	m
uigilia	f
uigiliarium	n
uigil_1	*
uigintiuiratus	m
uigor	m
uilicatio	f
uilitas	f
uilla	f
uillica	???
uillicus_1	m
uillius_n	m
uillula	f
uillus	m
uimen	n
uimentum	n
uinacea	f
uinaceus	*
uinalia_n	n
uinarium	n
uinarius_1	*
uinctus	m
uinculum	n
uindelici_n	*
uindemia	f
uindemiator	m
uindemitor	???
uindemitor_n	???
uindex	m
uindex_n	m
uindicatio	f
uindiciae	f
uindicius_n	m
uindicta	f
uindonissa_n	f
uinea	f
uinetum	n
uinicianus_n	*
uinicius_n	m
uinitor	m
uinius_n	m
uinnius_n	m
uinolentia	f
uinolentus_1	*
uinum	n
uinus	m
uiola	f
uiolarium	n
uiolarius	m
uiolatio	f
uiolator	m
uiolentia	f
uipera	f
uipsania_n	???
uipsanius_n	m
uipstanus_n	???
uir	m
uirago	f
uirbius_n	m
uirdius_n	m
uirdomarus_n	???
uirectum	n
uirentia	f
uirga	f
uirgator	m
uirgiliae	f
uirgilianus_n	*
uirgilius_n	*
uirginia_n	f
uirginitas	f
uirginius_n	*
uirgo	f
uirgo_n	f
uirgula	f
uirgultum	n
uirguncula	f
uiriatus_n	m
uiridarium	n
uiride	n
uiride_1	n
uiriditas	f
uiridomarus_n	m
uirilia	???
uirilitas	f
uiriola_n	f
uiromandui_n	*
uirro_n	m
uirtus	f
uirtus_n	f
uirus	m
uis	f
uisceratio	f
uiscum	???
uiscus_1	m
uiscus_2	m
uiscus_n	m
uisellius_n	*
uisidius_n	4
uistilia_n	???
uistilius_n	*
uisum	n
uisurgis_n	???
uisus	m
uita	f
uitalia	n
uitatio	f
uitellia_n	f
uitellius_n	*
uitellus	m
uitiarium	n
uitia_n	2
uiticula	f
uitis	f
uitisator	m
uitium	n
uitrarius_1	???
uitreum	n
uitricus	*
uitrum	n
uitta	f
uitula	f
uitulina	f
uitulus	m
uituperatio	f
uiuacitas	f
uiuarium	n
uiuens	n
uiuiradix	???
uiuum	n
uiuus_1	*
ulceratio	f
ulcus	n
ulcusculum	n
ulia_n	f
uligo	f
ulixes_n	m
ulixes_n	m
ulixeus_n	*
ulmus	f
ulna	f
ulpicum	n
ulteriora	2
ultimum_1	n
ultio	f
ultio_n	f
ultor	m
ultor_n	m
ultrix	f
ulua	f
ulubrae_n	f
ulula	f
ululatus	m
umbella	f
umbilicus	m
umbo	m
umbra	f
umbraculum	n
umbrenus_n	m
umbria_n	f
umbricius_n	m
umbri_n	m
umbrosa	n
umbro_n	m
ummidia_n	2
ummidius_n	*
unaetuicesimani	???
uncia	f
unciola	f
unctio	f
unctor	m
unctorium	n
unctum	n
uncus_1	m
unda	f
unelli_n	*
unetuicesimani	3
unguen	n
unguentarius_1	*
unguentum	n
unguiculus	m
unguis	m
ungula	f
unigena	f
unio_1	
unisubsellium	n
unitas	f
uniuersi	???
uniuersitas	f
uniuersum	n
unoculus	*
unum	neutre
uocabulum	n
uocamen	n
uocates_n	m
uocatio	f
uocator	m
uocatus	m
uoccio_n	m
uocetius_n	m
uociferatio	f
uoconius_n	*
uocontii_n	*
uocula	m
uocula_n	m
uolaginius_n	m
uolandum_n	n
uolanerius_n	m
uolans	n
uolantes	3
uolaterrae_n	???
uolaterrani_n	???
uolatus	m
uolcacius_n	???
uolcae_n	m
uolcanus_n	m
uolcens_n	m
uolesus_n	m
uologaesus_n	4
uologesus_n	m
uologesus_n	m
uolsci_n	*
uolsella	f
uolsinii_n	*
uolteius_n	4
uoltinia_n	2
uolturcius_n	m
uolubilitas	f
uolucris	???
uolumen	n
uolumnia_n	f
uolumnius_n	*
uoluntarii	m
uoluntas	f
uoluptas	f
uoluptas_n	f
uolusenus_n	m
uolusius_n	m
uolusus_n	m
uolutabrum	n
uolutatio	f
uolux_n	f
uomer	???
uomica	f
uomis	???
uomitor	m
uomitus	m
uonones_n	m
uopiscus_n	m
uorago	f
uoranus_n	m
uorenus_n	m
uortumnus_n	m
uosegus_n	m
uotienus_n	m
uotiuum	n
uotum	n
uox	f
upupa	f
urania_n	f
urbani	*
urbanitas	f
urbicus_n	*
urbinia_n	f
urbinum_n	n
urbs	*
urbs_n	*
urceolus	m
urceus	m
urgulania_n	???
urii_n	m
urina	f
urius_n	m
urna	f
ursa	f
ursaonenses_n	2
ursao_n	f
ursa_n	f
ursidius_n	???
ursina	f
ursus	m
urtica	f
uruca	f
urus	m
usio	f
usipetes_n	2
usipi_n	???
uspenses_n	2
usseta_n	2
ustica_n	f
ustor	m
usucapio_1	m
usura	f
usurpatio	f
usus	m
ususfructus	???
utensilia	n
uterum	???
uterus	???
uter_1	*
utica_n	f
uticenses_n	???
utile	neutre
utilitas	f
utriculus_1	m
utricus	4
uua	f
uulcanus_n	m
uulcatius_n	m
uulchalo_n	???
uulgator	m
uulgus	
uulneratio	f
uulnus	n
uulpecula	f
uulpes	f
uultum	n
uultur	m
uulturius	m
uulturnus_n	m
uultur_n	m
uultus	m
uulua	f
uxellodunum_n	???
uxii_n	*
uxor	f
uxorcula	f
uzitta_n	???
xanthippus_n	m
xanthus_n	m
xenippa_n	f
xenium	n
xenocrates_n	m
xenon_n	m
xenophantus_n	m
xenophilus_n	m
xenophon_n	m
xerxes_n	m
xiphias	m
xuthus_n	m
xystus	???
zacynthus_n	f
zalacus_n	4
zaleucus_n	m
zama_n	f
zamenses_n	???
zamia	f
zela_n	f
zenobia_n	f
zenon_n	???
zephyritis_n	f
zephyrus	m
zephyrus_n	m
zeta_n	f
zethus_n	m
zeuxis_n	m
ziobetis_n	???
zmaragdus	???
zoilus_n	m
zona	f
zonarius_1	*
zonula	f
zorsines_n	m
zosimus_n	m
zosippus_n	???
zotheca	f
zothecula	f
